Year,Period,labor force,employment,unemployment,unemployment rate,County
2014,Jan,6699,6049,650,9.7,"Aitkin County, MN"
2014,Feb,6688,6071,617,9.2,"Aitkin County, MN"
2014,Mar,6802,6153,649,9.5,"Aitkin County, MN"
2014,Apr,6756,6230,526,7.8,"Aitkin County, MN"
2014,May,6886,6458,428,6.2,"Aitkin County, MN"
2014,Jun,7003,6585,418,6.0,"Aitkin County, MN"
2014,Jul,6835,6436,399,5.8,"Aitkin County, MN"
2014,Aug,6816,6449,367,5.4,"Aitkin County, MN"
2014,Sep,6776,6446,330,4.9,"Aitkin County, MN"
2014,Oct,6739,6438,301,4.5,"Aitkin County, MN"
2014,Nov,6787,6384,403,5.9,"Aitkin County, MN"
2014,Dec,6723,6242,481,7.2,"Aitkin County, MN"
2015,Jan,6792,6167,625,9.2,"Aitkin County, MN"
2015,Feb,6768,6184,584,8.6,"Aitkin County, MN"
2015,Mar,6891,6283,608,8.8,"Aitkin County, MN"
2015,Apr,6872,6391,481,7.0,"Aitkin County, MN"
2015,May,6950,6552,398,5.7,"Aitkin County, MN"
2015,Jun,7051,6649,402,5.7,"Aitkin County, MN"
2015,Jul,6849,6478,371,5.4,"Aitkin County, MN"
2015,Aug,6787,6452,335,4.9,"Aitkin County, MN"
2015,Sep,6795,6489,306,4.5,"Aitkin County, MN"
2015,Oct,6898,6560,338,4.9,"Aitkin County, MN"
2015,Nov,6982,6499,483,6.9,"Aitkin County, MN"
2015,Dec,7076,6474,602,8.5,"Aitkin County, MN"
2016,Jan,6991,6342,649,9.3,"Aitkin County, MN"
2016,Feb,7047,6407,640,9.1,"Aitkin County, MN"
2016,Mar,7067,6371,696,9.8,"Aitkin County, MN"
2016,Apr,7042,6511,531,7.5,"Aitkin County, MN"
2016,May,7052,6665,387,5.5,"Aitkin County, MN"
2016,Jun,7086,6657,429,6.1,"Aitkin County, MN"
2016,Jul,7023,6620,403,5.7,"Aitkin County, MN"
2016,Aug,6952,6566,386,5.6,"Aitkin County, MN"
2016,Sep,6911,6556,355,5.1,"Aitkin County, MN"
2016,Oct,6976,6619,357,5.1,"Aitkin County, MN"
2016,Nov,7018,6555,463,6.6,"Aitkin County, MN"
2016,Dec,7124,6501,623,8.7,"Aitkin County, MN"
2017,Jan,7288,6587,701,9.6,"Aitkin County, MN"
2017,Feb,7305,6649,656,9.0,"Aitkin County, MN"
2017,Mar,7342,6692,650,8.9,"Aitkin County, MN"
2017,Apr,7158,6649,509,7.1,"Aitkin County, MN"
2017,May,7177,6812,365,5.1,"Aitkin County, MN"
2017,Jun,7257,6894,363,5.0,"Aitkin County, MN"
2017,Jul,7170,6844,326,4.5,"Aitkin County, MN"
2017,Aug,7106,6796,310,4.4,"Aitkin County, MN"
2017,Sep,7128,6855,273,3.8,"Aitkin County, MN"
2017,Oct,7122,6868,254,3.6,"Aitkin County, MN"
2017,Nov,7225,6773,452,6.3,"Aitkin County, MN"
2017,Dec,7249,6670,579,8.0,"Aitkin County, MN"
2018,Jan,7198,6548,650,9.0,"Aitkin County, MN"
2018,Feb,7205,6601,604,8.4,"Aitkin County, MN"
2018,Mar,7186,6598,588,8.2,"Aitkin County, MN"
2018,Apr,7179,6704,475,6.6,"Aitkin County, MN"
2018,May,7221,6910,311,4.3,"Aitkin County, MN"
2018,Jun,7333,7012,321,4.4,"Aitkin County, MN"
2018,Jul,7205,6907,298,4.1,"Aitkin County, MN"
2018,Aug,7070,6811,259,3.7,"Aitkin County, MN"
2018,Sep,7024,6804,220,3.1,"Aitkin County, MN"
2018,Oct,7180,6943,237,3.3,"Aitkin County, MN"
2018,Nov,7221,6800,421,5.8,"Aitkin County, MN"
2018,Dec,7352,6754,598,8.1,"Aitkin County, MN"
2019,Jan,7358,6616,742,10.1,"Aitkin County, MN"
2019,Feb,7283,6630,653,9.0,"Aitkin County, MN"
2019,Mar,7290,6662,628,8.6,"Aitkin County, MN"
2019,Apr,7216,6712,504,7.0,"Aitkin County, MN"
2019,May,7339,7000,339,4.6,"Aitkin County, MN"
2019,Jun,7488,7135,353,4.7,"Aitkin County, MN"
2019,Jul,7396,7041,355,4.8,"Aitkin County, MN"
2019,Aug,7254,6938,316,4.4,"Aitkin County, MN"
2019,Sep,7189,6942,247,3.4,"Aitkin County, MN"
2019,Oct,7266,6967,299,4.1,"Aitkin County, MN"
2019,Nov,7327,6906,421,5.7,"Aitkin County, MN"
2019,Dec,7436,6815,621,8.4,"Aitkin County, MN"
2020,Jan,7507,6800,707,9.4,"Aitkin County, MN"
2020,Feb,7441,6830,611,8.2,"Aitkin County, MN"
2020,Mar,7527,6798,729,9.7,"Aitkin County, MN"
2020,Apr,7049,6236,813,11.5,"Aitkin County, MN"
2020,May,7283,6361,922,12.7,"Aitkin County, MN"
2020,Jun,7724,7006,718,9.3,"Aitkin County, MN"
2020,Jul,7733,7137,596,7.7,"Aitkin County, MN"
2020,Aug,7780,7299,481,6.2,"Aitkin County, MN"
2020,Sep,7623,7200,423,5.5,"Aitkin County, MN"
2020,Oct,7617,7238,379,5.0,"Aitkin County, MN"
2020,Nov,7538,7095,443,5.9,"Aitkin County, MN"
2020,Dec,7316,6711,605,8.3,"Aitkin County, MN"
2021,Jan,7307,6654,653,8.9,"Aitkin County, MN"
2021,Feb,7342,6770,572,7.8,"Aitkin County, MN"
2021,Mar,7298,6756,542,7.4,"Aitkin County, MN"
2021,Apr,7298,6875,423,5.8,"Aitkin County, MN"
2021,May,7428,7117,311,4.2,"Aitkin County, MN"
2021,Jun,7563,7217,346,4.6,"Aitkin County, MN"
2021,Jul,7515,7240,275,3.7,"Aitkin County, MN"
2021,Aug,7456,7177,279,3.7,"Aitkin County, MN"
2021,Sep,7439,7202,237,3.2,"Aitkin County, MN"
2021,Oct,7444,7219,225,3.0,"Aitkin County, MN"
2021,Nov,7449,7187,262,3.5,"Aitkin County, MN"
2021,Dec,7449,7056,393,5.3,"Aitkin County, MN"
2022,Jan,7396,6905,491,6.6,"Aitkin County, MN"
2022,Feb,7430,6986,444,6.0,"Aitkin County, MN"
2022,Mar,7427,7012,415,5.6,"Aitkin County, MN"
2022,Apr,7346,7029,317,4.3,"Aitkin County, MN"
2022,May,7465,7208,257,3.4,"Aitkin County, MN"
2022,Jun,7563,7310,253,3.3,"Aitkin County, MN"
2022,Jul,7465,7244,221,3.0,"Aitkin County, MN"
2022,Aug,7523,7281,242,3.2,"Aitkin County, MN"
2022,Sep,7414,7209,205,2.8,"Aitkin County, MN"
2022,Oct,7351,7133,218,3.0,"Aitkin County, MN"
2022,Nov,7311,6999,312,4.3,"Aitkin County, MN"
2022,Dec,7390,6923,467,6.3,"Aitkin County, MN"
2023,Jan,7558,7029,529,7.0,"Aitkin County, MN"
2023,Feb,7576,7033,543,7.2,"Aitkin County, MN"
2023,Mar,7555,7055,500,6.6,"Aitkin County, MN"
2023,Apr,7494,7070,424,5.7,"Aitkin County, MN"
2023,May,7588,7257,331,4.4,"Aitkin County, MN"
2023,Jun,7697,7366,331,4.3,"Aitkin County, MN"
2023,Jul,7538,7257,281,3.7,"Aitkin County, MN"
2023,Aug,7524,7241,283,3.8,"Aitkin County, MN"
2023,Sep,7419,7211,208,2.8,"Aitkin County, MN"
2023,Oct,7420,7204,216,2.9,"Aitkin County, MN"
2023,Nov,7399,7127,272,3.7,"Aitkin County, MN"
2023,Dec,7404,7014,390,5.3,"Aitkin County, MN"
2024,Jan,7446,6961,485,6.5,"Aitkin County, MN"
2024,Feb,7498,6973,525,7.0,"Aitkin County, MN"
2024,Mar,7541,7054,487,6.5,"Aitkin County, MN"
2024,Apr,7487,7101,386,5.2,"Aitkin County, MN"
2024,May,7556,7175,381,5.0,"Aitkin County, MN"
2024,Jun,7580,7203,377,5.0,"Aitkin County, MN"
2024,Jul,7510,7132,378,5.0,"Aitkin County, MN"
2024,Aug,7547,7194,353,4.7,"Aitkin County, MN"
2024,Sep,7448,7199,249,3.3,"Aitkin County, MN"
2024,Oct,7480,7235,245,3.3,"Aitkin County, MN"
2024,Nov,7512(P),7144(P),368(P),4.9(P),"Aitkin County, MN"
P : Preliminary.,P : Preliminary.,P : Preliminary.,P : Preliminary.,P : Preliminary.,P : Preliminary.,"Aitkin County, MN"
2014,Jan,187589,177702,9887,5.3,"Anoka County, MN"
2014,Feb,187991,178097,9894,5.3,"Anoka County, MN"
2014,Mar,188720,178805,9915,5.3,"Anoka County, MN"
2014,Apr,188870,180751,8119,4.3,"Anoka County, MN"
2014,May,189806,182180,7626,4.0,"Anoka County, MN"
2014,Jun,191199,182831,8368,4.4,"Anoka County, MN"
2014,Jul,191698,183631,8067,4.2,"Anoka County, MN"
2014,Aug,189913,182361,7552,4.0,"Anoka County, MN"
2014,Sep,189187,182197,6990,3.7,"Anoka County, MN"
2014,Oct,189474,183140,6334,3.3,"Anoka County, MN"
2014,Nov,189834,183245,6589,3.5,"Anoka County, MN"
2014,Dec,189206,182032,7174,3.8,"Anoka County, MN"
2015,Jan,188077,179685,8392,4.5,"Anoka County, MN"
2015,Feb,189056,180911,8145,4.3,"Anoka County, MN"
2015,Mar,188605,180519,8086,4.3,"Anoka County, MN"
2015,Apr,190045,183350,6695,3.5,"Anoka County, MN"
2015,May,191927,185185,6742,3.5,"Anoka County, MN"
2015,Jun,191717,184296,7421,3.9,"Anoka County, MN"
2015,Jul,193048,185865,7183,3.7,"Anoka County, MN"
2015,Aug,191393,184700,6693,3.5,"Anoka County, MN"
2015,Sep,189758,183503,6255,3.3,"Anoka County, MN"
2015,Oct,189486,183456,6030,3.2,"Anoka County, MN"
2015,Nov,190062,184205,5857,3.1,"Anoka County, MN"
2015,Dec,190394,183524,6870,3.6,"Anoka County, MN"
2016,Jan,189284,181315,7969,4.2,"Anoka County, MN"
2016,Feb,191110,183146,7964,4.2,"Anoka County, MN"
2016,Mar,190875,182727,8148,4.3,"Anoka County, MN"
2016,Apr,191387,184729,6658,3.5,"Anoka County, MN"
2016,May,191560,185450,6110,3.2,"Anoka County, MN"
2016,Jun,192185,184704,7481,3.9,"Anoka County, MN"
2016,Jul,194441,187256,7185,3.7,"Anoka County, MN"
2016,Aug,193454,186294,7160,3.7,"Anoka County, MN"
2016,Sep,192863,186061,6802,3.5,"Anoka County, MN"
2016,Oct,191576,184991,6585,3.4,"Anoka County, MN"
2016,Nov,191261,184996,6265,3.3,"Anoka County, MN"
2016,Dec,191452,184024,7428,3.9,"Anoka County, MN"
2017,Jan,193130,184723,8407,4.4,"Anoka County, MN"
2017,Feb,194688,186459,8229,4.2,"Anoka County, MN"
2017,Mar,195429,187617,7812,4.0,"Anoka County, MN"
2017,Apr,195534,189048,6486,3.3,"Anoka County, MN"
2017,May,195605,189478,6127,3.1,"Anoka County, MN"
2017,Jun,197715,190642,7073,3.6,"Anoka County, MN"
2017,Jul,199155,192455,6700,3.4,"Anoka County, MN"
2017,Aug,197888,191275,6613,3.3,"Anoka County, MN"
2017,Sep,197867,192158,5709,2.9,"Anoka County, MN"
2017,Oct,195381,190372,5009,2.6,"Anoka County, MN"
2017,Nov,196124,190873,5251,2.7,"Anoka County, MN"
2017,Dec,195917,189716,6201,3.2,"Anoka County, MN"
2018,Jan,195807,188982,6825,3.5,"Anoka County, MN"
2018,Feb,197468,190624,6844,3.5,"Anoka County, MN"
2018,Mar,196546,189781,6765,3.4,"Anoka County, MN"
2018,Apr,195598,190153,5445,2.8,"Anoka County, MN"
2018,May,195980,191245,4735,2.4,"Anoka County, MN"
2018,Jun,197833,191854,5979,3.0,"Anoka County, MN"
2018,Jul,198543,193168,5375,2.7,"Anoka County, MN"
2018,Aug,197192,191910,5282,2.7,"Anoka County, MN"
2018,Sep,196507,191726,4781,2.4,"Anoka County, MN"
2018,Oct,196601,191929,4672,2.4,"Anoka County, MN"
2018,Nov,197218,192559,4659,2.4,"Anoka County, MN"
2018,Dec,197850,191571,6279,3.2,"Anoka County, MN"
2019,Jan,198776,191170,7606,3.8,"Anoka County, MN"
2019,Feb,199405,192296,7109,3.6,"Anoka County, MN"
2019,Mar,199014,191706,7308,3.7,"Anoka County, MN"
2019,Apr,198145,192411,5734,2.9,"Anoka County, MN"
2019,May,198495,192873,5622,2.8,"Anoka County, MN"
2019,Jun,200896,194141,6755,3.4,"Anoka County, MN"
2019,Jul,201482,195198,6284,3.1,"Anoka County, MN"
2019,Aug,201109,195056,6053,3.0,"Anoka County, MN"
2019,Sep,200354,195099,5255,2.6,"Anoka County, MN"
2019,Oct,200139,194790,5349,2.7,"Anoka County, MN"
2019,Nov,200551,195225,5326,2.7,"Anoka County, MN"
2019,Dec,201204,194960,6244,3.1,"Anoka County, MN"
2020,Jan,202713,195646,7067,3.5,"Anoka County, MN"
2020,Feb,203535,196534,7001,3.4,"Anoka County, MN"
2020,Mar,202852,193708,9144,4.5,"Anoka County, MN"
2020,Apr,192717,175167,17550,9.1,"Anoka County, MN"
2020,May,196202,172867,23335,11.9,"Anoka County, MN"
2020,Jun,203920,184246,19674,9.6,"Anoka County, MN"
2020,Jul,205308,187719,17589,8.6,"Anoka County, MN"
2020,Aug,204346,190879,13467,6.6,"Anoka County, MN"
2020,Sep,202176,190074,12102,6.0,"Anoka County, MN"
2020,Oct,201102,191180,9922,4.9,"Anoka County, MN"
2020,Nov,199927,191410,8517,4.3,"Anoka County, MN"
2020,Dec,197098,186925,10173,5.2,"Anoka County, MN"
2021,Jan,194581,184669,9912,5.1,"Anoka County, MN"
2021,Feb,194745,185591,9154,4.7,"Anoka County, MN"
2021,Mar,195035,186130,8905,4.6,"Anoka County, MN"
2021,Apr,195390,187460,7930,4.1,"Anoka County, MN"
2021,May,195306,188094,7212,3.7,"Anoka County, MN"
2021,Jun,196106,187627,8479,4.3,"Anoka County, MN"
2021,Jul,196870,189616,7254,3.7,"Anoka County, MN"
2021,Aug,195527,188534,6993,3.6,"Anoka County, MN"
2021,Sep,194524,188343,6181,3.2,"Anoka County, MN"
2021,Oct,194963,189622,5341,2.7,"Anoka County, MN"
2021,Nov,196028,191428,4600,2.3,"Anoka County, MN"
2021,Dec,196148,190840,5308,2.7,"Anoka County, MN"
2022,Jan,196538,190078,6460,3.3,"Anoka County, MN"
2022,Feb,196825,191042,5783,2.9,"Anoka County, MN"
2022,Mar,197268,191676,5592,2.8,"Anoka County, MN"
2022,Apr,197843,193736,4107,2.1,"Anoka County, MN"
2022,May,198687,194573,4114,2.1,"Anoka County, MN"
2022,Jun,199003,193692,5311,2.7,"Anoka County, MN"
2022,Jul,199521,194670,4851,2.4,"Anoka County, MN"
2022,Aug,199434,194204,5230,2.6,"Anoka County, MN"
2022,Sep,198476,194073,4403,2.2,"Anoka County, MN"
2022,Oct,196860,192576,4284,2.2,"Anoka County, MN"
2022,Nov,196846,192520,4326,2.2,"Anoka County, MN"
2022,Dec,197583,192145,5438,2.8,"Anoka County, MN"
2023,Jan,197730,191696,6034,3.1,"Anoka County, MN"
2023,Feb,198558,192166,6392,3.2,"Anoka County, MN"
2023,Mar,199590,193314,6276,3.1,"Anoka County, MN"
2023,Apr,199764,194460,5304,2.7,"Anoka County, MN"
2023,May,200612,195367,5245,2.6,"Anoka County, MN"
2023,Jun,202938,196272,6666,3.3,"Anoka County, MN"
2023,Jul,202653,196623,6030,3.0,"Anoka County, MN"
2023,Aug,201082,194589,6493,3.2,"Anoka County, MN"
2023,Sep,199552,194835,4717,2.4,"Anoka County, MN"
2023,Oct,198618,194145,4473,2.3,"Anoka County, MN"
2023,Nov,198272,194627,3645,1.8,"Anoka County, MN"
2023,Dec,197480,192623,4857,2.5,"Anoka County, MN"
2024,Jan,198455,192246,6209,3.1,"Anoka County, MN"
2024,Feb,199862,192820,7042,3.5,"Anoka County, MN"
2024,Mar,199818,193559,6259,3.1,"Anoka County, MN"
2024,Apr,199533,194283,5250,2.6,"Anoka County, MN"
2024,May,198837,193595,5242,2.6,"Anoka County, MN"
2024,Jun,199135,191244,7891,4.0,"Anoka County, MN"
2024,Jul,199544,191583,7961,4.0,"Anoka County, MN"
2024,Aug,198405,190138,8267,4.2,"Anoka County, MN"
2024,Sep,197116,191207,5909,3.0,"Anoka County, MN"
2024,Oct,197417,192061,5356,2.7,"Anoka County, MN"
2024,Nov,197188(P),191317(P),5871(P),3.0(P),"Anoka County, MN"
P : Preliminary.,P : Preliminary.,P : Preliminary.,P : Preliminary.,P : Preliminary.,P : Preliminary.,"Anoka County, MN"
2014,Jan,17672,16422,1250,7.1,"Becker County, MN"
2014,Feb,17540,16320,1220,7.0,"Becker County, MN"
2014,Mar,17780,16490,1290,7.3,"Becker County, MN"
2014,Apr,17755,16788,967,5.4,"Becker County, MN"
2014,May,17999,17282,717,4.0,"Becker County, MN"
2014,Jun,18269,17489,780,4.3,"Becker County, MN"
2014,Jul,18130,17378,752,4.1,"Becker County, MN"
2014,Aug,19380,18688,692,3.6,"Becker County, MN"
2014,Sep,17694,17089,605,3.4,"Becker County, MN"
2014,Oct,17911,17339,572,3.2,"Becker County, MN"
2014,Nov,18037,17293,744,4.1,"Becker County, MN"
2014,Dec,18058,17096,962,5.3,"Becker County, MN"
2015,Jan,18243,17142,1101,6.0,"Becker County, MN"
2015,Feb,18096,17048,1048,5.8,"Becker County, MN"
2015,Mar,18286,17211,1075,5.9,"Becker County, MN"
2015,Apr,18340,17552,788,4.3,"Becker County, MN"
2015,May,18547,17837,710,3.8,"Becker County, MN"
2015,Jun,19049,18260,789,4.1,"Becker County, MN"
2015,Jul,18514,17765,749,4.0,"Becker County, MN"
2015,Aug,19104,18444,660,3.5,"Becker County, MN"
2015,Sep,18152,17541,611,3.4,"Becker County, MN"
2015,Oct,18252,17659,593,3.2,"Becker County, MN"
2015,Nov,18245,17486,759,4.2,"Becker County, MN"
2015,Dec,18517,17507,1010,5.5,"Becker County, MN"
2016,Jan,18700,17547,1153,6.2,"Becker County, MN"
2016,Feb,18588,17469,1119,6.0,"Becker County, MN"
2016,Mar,18757,17576,1181,6.3,"Becker County, MN"
2016,Apr,18433,17622,811,4.4,"Becker County, MN"
2016,May,18417,17767,650,3.5,"Becker County, MN"
2016,Jun,18828,18027,801,4.3,"Becker County, MN"
2016,Jul,18423,17674,749,4.1,"Becker County, MN"
2016,Aug,19407,18704,703,3.6,"Becker County, MN"
2016,Sep,18078,17409,669,3.7,"Becker County, MN"
2016,Oct,18228,17620,608,3.3,"Becker County, MN"
2016,Nov,18291,17578,713,3.9,"Becker County, MN"
2016,Dec,18419,17399,1020,5.5,"Becker County, MN"
2017,Jan,18498,17304,1194,6.5,"Becker County, MN"
2017,Feb,18488,17376,1112,6.0,"Becker County, MN"
2017,Mar,18518,17466,1052,5.7,"Becker County, MN"
2017,Apr,18322,17550,772,4.2,"Becker County, MN"
2017,May,18459,17852,607,3.3,"Becker County, MN"
2017,Jun,18918,18230,688,3.6,"Becker County, MN"
2017,Jul,18678,18015,663,3.5,"Becker County, MN"
2017,Aug,19292,18657,635,3.3,"Becker County, MN"
2017,Sep,18781,18261,520,2.8,"Becker County, MN"
2017,Oct,18500,18022,478,2.6,"Becker County, MN"
2017,Nov,18595,17834,761,4.1,"Becker County, MN"
2017,Dec,18750,17805,945,5.0,"Becker County, MN"
2018,Jan,18271,17230,1041,5.7,"Becker County, MN"
2018,Feb,18350,17386,964,5.3,"Becker County, MN"
2018,Mar,18315,17334,981,5.4,"Becker County, MN"
2018,Apr,18544,17801,743,4.0,"Becker County, MN"
2018,May,18938,18429,509,2.7,"Becker County, MN"
2018,Jun,19201,18588,613,3.2,"Becker County, MN"
2018,Jul,18939,18393,546,2.9,"Becker County, MN"
2018,Aug,18826,18329,497,2.6,"Becker County, MN"
2018,Sep,18395,17953,442,2.4,"Becker County, MN"
2018,Oct,18579,18155,424,2.3,"Becker County, MN"
2018,Nov,18551,17980,571,3.1,"Becker County, MN"
2018,Dec,18658,17787,871,4.7,"Becker County, MN"
2019,Jan,18502,17397,1105,6.0,"Becker County, MN"
2019,Feb,18494,17453,1041,5.6,"Becker County, MN"
2019,Mar,18481,17399,1082,5.9,"Becker County, MN"
2019,Apr,18682,17885,797,4.3,"Becker County, MN"
2019,May,19151,18603,548,2.9,"Becker County, MN"
2019,Jun,19483,18798,685,3.5,"Becker County, MN"
2019,Jul,19300,18635,665,3.4,"Becker County, MN"
2019,Aug,19090,18536,554,2.9,"Becker County, MN"
2019,Sep,18916,18435,481,2.5,"Becker County, MN"
2019,Oct,18854,18381,473,2.5,"Becker County, MN"
2019,Nov,18787,18145,642,3.4,"Becker County, MN"
2019,Dec,18936,17970,966,5.1,"Becker County, MN"
2020,Jan,18987,17852,1135,6.0,"Becker County, MN"
2020,Feb,19064,17957,1107,5.8,"Becker County, MN"
2020,Mar,18882,17654,1228,6.5,"Becker County, MN"
2020,Apr,18266,16387,1879,10.3,"Becker County, MN"
2020,May,18636,16723,1913,10.3,"Becker County, MN"
2020,Jun,19493,17926,1567,8.0,"Becker County, MN"
2020,Jul,19606,18373,1233,6.3,"Becker County, MN"
2020,Aug,19333,18378,955,4.9,"Becker County, MN"
2020,Sep,19051,18200,851,4.5,"Becker County, MN"
2020,Oct,19280,18540,740,3.8,"Becker County, MN"
2020,Nov,18967,18172,795,4.2,"Becker County, MN"
2020,Dec,18696,17678,1018,5.4,"Becker County, MN"
2021,Jan,18962,17799,1163,6.1,"Becker County, MN"
2021,Feb,18854,17823,1031,5.5,"Becker County, MN"
2021,Mar,18804,17828,976,5.2,"Becker County, MN"
2021,Apr,18869,18172,697,3.7,"Becker County, MN"
2021,May,19347,18801,546,2.8,"Becker County, MN"
2021,Jun,19605,18926,679,3.5,"Becker County, MN"
2021,Jul,19604,19025,579,3.0,"Becker County, MN"
2021,Aug,19465,18934,531,2.7,"Becker County, MN"
2021,Sep,19187,18732,455,2.4,"Becker County, MN"
2021,Oct,19147,18730,417,2.2,"Becker County, MN"
2021,Nov,18968,18512,456,2.4,"Becker County, MN"
2021,Dec,19300,18656,644,3.3,"Becker County, MN"
2022,Jan,18897,18090,807,4.3,"Becker County, MN"
2022,Feb,18984,18236,748,3.9,"Becker County, MN"
2022,Mar,18980,18283,697,3.7,"Becker County, MN"
2022,Apr,18969,18471,498,2.6,"Becker County, MN"
2022,May,19320,18908,412,2.1,"Becker County, MN"
2022,Jun,19798,19285,513,2.6,"Becker County, MN"
2022,Jul,19763,19289,474,2.4,"Becker County, MN"
2022,Aug,20003,19545,458,2.3,"Becker County, MN"
2022,Sep,19434,19067,367,1.9,"Becker County, MN"
2022,Oct,19273,18896,377,2.0,"Becker County, MN"
2022,Nov,19120,18668,452,2.4,"Becker County, MN"
2022,Dec,19467,18727,740,3.8,"Becker County, MN"
2023,Jan,19318,18473,845,4.4,"Becker County, MN"
2023,Feb,19305,18445,860,4.5,"Becker County, MN"
2023,Mar,19207,18422,785,4.1,"Becker County, MN"
2023,Apr,19308,18624,684,3.5,"Becker County, MN"
2023,May,19498,19042,456,2.3,"Becker County, MN"
2023,Jun,20023,19442,581,2.9,"Becker County, MN"
2023,Jul,19522,18973,549,2.8,"Becker County, MN"
2023,Aug,20123,19577,546,2.7,"Becker County, MN"
2023,Sep,19667,19305,362,1.8,"Becker County, MN"
2023,Oct,19410,19067,343,1.8,"Becker County, MN"
2023,Nov,19366,18995,371,1.9,"Becker County, MN"
2023,Dec,19406,18803,603,3.1,"Becker County, MN"
2024,Jan,19402,18575,827,4.3,"Becker County, MN"
2024,Feb,19398,18525,873,4.5,"Becker County, MN"
2024,Mar,19499,18744,755,3.9,"Becker County, MN"
2024,Apr,19511,18974,537,2.8,"Becker County, MN"
2024,May,19662,19117,545,2.8,"Becker County, MN"
2024,Jun,20157,19470,687,3.4,"Becker County, MN"
2024,Jul,19877,19185,692,3.5,"Becker County, MN"
2024,Aug,20542,19857,685,3.3,"Becker County, MN"
2024,Sep,20052,19574,478,2.4,"Becker County, MN"
2024,Oct,19481,19034,447,2.3,"Becker County, MN"
2024,Nov,19559(P),18972(P),587(P),3.0(P),"Becker County, MN"
P : Preliminary.,P : Preliminary.,P : Preliminary.,P : Preliminary.,P : Preliminary.,P : Preliminary.,"Becker County, MN"
2014,Jan,23022,21339,1683,7.3,"Beltrami County, MN"
2014,Feb,23174,21546,1628,7.0,"Beltrami County, MN"
2014,Mar,23361,21735,1626,7.0,"Beltrami County, MN"
2014,Apr,23286,21925,1361,5.8,"Beltrami County, MN"
2014,May,23406,22235,1171,5.0,"Beltrami County, MN"
2014,Jun,23399,22143,1256,5.4,"Beltrami County, MN"
2014,Jul,23461,22247,1214,5.2,"Beltrami County, MN"
2014,Aug,23138,22031,1107,4.8,"Beltrami County, MN"
2014,Sep,23470,22489,981,4.2,"Beltrami County, MN"
2014,Oct,23575,22664,911,3.9,"Beltrami County, MN"
2014,Nov,23767,22675,1092,4.6,"Beltrami County, MN"
2014,Dec,23366,22117,1249,5.3,"Beltrami County, MN"
2015,Jan,23197,21743,1454,6.3,"Beltrami County, MN"
2015,Feb,23391,21997,1394,6.0,"Beltrami County, MN"
2015,Mar,23424,22022,1402,6.0,"Beltrami County, MN"
2015,Apr,23680,22491,1189,5.0,"Beltrami County, MN"
2015,May,23749,22658,1091,4.6,"Beltrami County, MN"
2015,Jun,23672,22485,1187,5.0,"Beltrami County, MN"
2015,Jul,23521,22407,1114,4.7,"Beltrami County, MN"
2015,Aug,23374,22366,1008,4.3,"Beltrami County, MN"
2015,Sep,23584,22647,937,4.0,"Beltrami County, MN"
2015,Oct,23678,22739,939,4.0,"Beltrami County, MN"
2015,Nov,23722,22649,1073,4.5,"Beltrami County, MN"
2015,Dec,23789,22401,1388,5.8,"Beltrami County, MN"
2016,Jan,23572,22076,1496,6.3,"Beltrami County, MN"
2016,Feb,23739,22282,1457,6.1,"Beltrami County, MN"
2016,Mar,24090,22513,1577,6.5,"Beltrami County, MN"
2016,Apr,23878,22584,1294,5.4,"Beltrami County, MN"
2016,May,23484,22388,1096,4.7,"Beltrami County, MN"
2016,Jun,23581,22305,1276,5.4,"Beltrami County, MN"
2016,Jul,23561,22403,1158,4.9,"Beltrami County, MN"
2016,Aug,23454,22328,1126,4.8,"Beltrami County, MN"
2016,Sep,23701,22685,1016,4.3,"Beltrami County, MN"
2016,Oct,23640,22671,969,4.1,"Beltrami County, MN"
2016,Nov,23571,22551,1020,4.3,"Beltrami County, MN"
2016,Dec,23674,22339,1335,5.6,"Beltrami County, MN"
2017,Jan,23741,22121,1620,6.8,"Beltrami County, MN"
2017,Feb,23930,22412,1518,6.3,"Beltrami County, MN"
2017,Mar,23924,22441,1483,6.2,"Beltrami County, MN"
2017,Apr,23786,22622,1164,4.9,"Beltrami County, MN"
2017,May,23623,22614,1009,4.3,"Beltrami County, MN"
2017,Jun,23790,22644,1146,4.8,"Beltrami County, MN"
2017,Jul,23757,22691,1066,4.5,"Beltrami County, MN"
2017,Aug,23687,22647,1040,4.4,"Beltrami County, MN"
2017,Sep,23659,22823,836,3.5,"Beltrami County, MN"
2017,Oct,23597,22816,781,3.3,"Beltrami County, MN"
2017,Nov,23852,22726,1126,4.7,"Beltrami County, MN"
2017,Dec,23847,22608,1239,5.2,"Beltrami County, MN"
2018,Jan,23846,22444,1402,5.9,"Beltrami County, MN"
2018,Feb,24002,22714,1288,5.4,"Beltrami County, MN"
2018,Mar,23934,22588,1346,5.6,"Beltrami County, MN"
2018,Apr,24191,23098,1093,4.5,"Beltrami County, MN"
2018,May,24140,23226,914,3.8,"Beltrami County, MN"
2018,Jun,24306,23297,1009,4.2,"Beltrami County, MN"
2018,Jul,24380,23489,891,3.7,"Beltrami County, MN"
2018,Aug,24338,23464,874,3.6,"Beltrami County, MN"
2018,Sep,24223,23511,712,2.9,"Beltrami County, MN"
2018,Oct,24217,23522,695,2.9,"Beltrami County, MN"
2018,Nov,24227,23376,851,3.5,"Beltrami County, MN"
2018,Dec,24469,23293,1176,4.8,"Beltrami County, MN"
2019,Jan,24270,22845,1425,5.9,"Beltrami County, MN"
2019,Feb,24409,23125,1284,5.3,"Beltrami County, MN"
2019,Mar,24424,23130,1294,5.3,"Beltrami County, MN"
2019,Apr,24134,23092,1042,4.3,"Beltrami County, MN"
2019,May,24306,23412,894,3.7,"Beltrami County, MN"
2019,Jun,24597,23551,1046,4.3,"Beltrami County, MN"
2019,Jul,24527,23540,987,4.0,"Beltrami County, MN"
2019,Aug,24675,23748,927,3.8,"Beltrami County, MN"
2019,Sep,24663,23907,756,3.1,"Beltrami County, MN"
2019,Oct,24659,23871,788,3.2,"Beltrami County, MN"
2019,Nov,24680,23686,994,4.0,"Beltrami County, MN"
2019,Dec,24803,23551,1252,5.0,"Beltrami County, MN"
2020,Jan,24715,23302,1413,5.7,"Beltrami County, MN"
2020,Feb,24841,23528,1313,5.3,"Beltrami County, MN"
2020,Mar,24845,23251,1594,6.4,"Beltrami County, MN"
2020,Apr,23662,21440,2222,9.4,"Beltrami County, MN"
2020,May,24590,22057,2533,10.3,"Beltrami County, MN"
2020,Jun,25655,23594,2061,8.0,"Beltrami County, MN"
2020,Jul,25790,23925,1865,7.2,"Beltrami County, MN"
2020,Aug,25858,24484,1374,5.3,"Beltrami County, MN"
2020,Sep,25336,24136,1200,4.7,"Beltrami County, MN"
2020,Oct,25237,24131,1106,4.4,"Beltrami County, MN"
2020,Nov,24911,23743,1168,4.7,"Beltrami County, MN"
2020,Dec,24502,23156,1346,5.5,"Beltrami County, MN"
2021,Jan,24609,23193,1416,5.8,"Beltrami County, MN"
2021,Feb,24594,23307,1287,5.2,"Beltrami County, MN"
2021,Mar,24627,23330,1297,5.3,"Beltrami County, MN"
2021,Apr,24656,23554,1102,4.5,"Beltrami County, MN"
2021,May,24539,23600,939,3.8,"Beltrami County, MN"
2021,Jun,24808,23745,1063,4.3,"Beltrami County, MN"
2021,Jul,24746,23853,893,3.6,"Beltrami County, MN"
2021,Aug,24704,23853,851,3.4,"Beltrami County, MN"
2021,Sep,24588,23908,680,2.8,"Beltrami County, MN"
2021,Oct,24410,23770,640,2.6,"Beltrami County, MN"
2021,Nov,24410,23735,675,2.8,"Beltrami County, MN"
2021,Dec,24652,23786,866,3.5,"Beltrami County, MN"
2022,Jan,24741,23643,1098,4.4,"Beltrami County, MN"
2022,Feb,24678,23690,988,4.0,"Beltrami County, MN"
2022,Mar,24924,23969,955,3.8,"Beltrami County, MN"
2022,Apr,24799,24005,794,3.2,"Beltrami County, MN"
2022,May,24908,24211,697,2.8,"Beltrami County, MN"
2022,Jun,25154,24394,760,3.0,"Beltrami County, MN"
2022,Jul,25412,24720,692,2.7,"Beltrami County, MN"
2022,Aug,25374,24645,729,2.9,"Beltrami County, MN"
2022,Sep,25053,24517,536,2.1,"Beltrami County, MN"
2022,Oct,24929,24412,517,2.1,"Beltrami County, MN"
2022,Nov,24864,24195,669,2.7,"Beltrami County, MN"
2022,Dec,25285,24339,946,3.7,"Beltrami County, MN"
2023,Jan,24991,23902,1089,4.4,"Beltrami County, MN"
2023,Feb,25141,23981,1160,4.6,"Beltrami County, MN"
2023,Mar,25229,24128,1101,4.4,"Beltrami County, MN"
2023,Apr,25126,24151,975,3.9,"Beltrami County, MN"
2023,May,25298,24469,829,3.3,"Beltrami County, MN"
2023,Jun,25826,24823,1003,3.9,"Beltrami County, MN"
2023,Jul,25773,24868,905,3.5,"Beltrami County, MN"
2023,Aug,25502,24517,985,3.9,"Beltrami County, MN"
2023,Sep,24945,24367,578,2.3,"Beltrami County, MN"
2023,Oct,24805,24264,541,2.2,"Beltrami County, MN"
2023,Nov,24778,24201,577,2.3,"Beltrami County, MN"
2023,Dec,24772,23968,804,3.2,"Beltrami County, MN"
2024,Jan,24762,23744,1018,4.1,"Beltrami County, MN"
2024,Feb,24904,23777,1127,4.5,"Beltrami County, MN"
2024,Mar,25015,23995,1020,4.1,"Beltrami County, MN"
2024,Apr,24916,24065,851,3.4,"Beltrami County, MN"
2024,May,24858,24061,797,3.2,"Beltrami County, MN"
2024,Jun,25262,24093,1169,4.6,"Beltrami County, MN"
2024,Jul,25348,24176,1172,4.6,"Beltrami County, MN"
2024,Aug,25386,24180,1206,4.8,"Beltrami County, MN"
2024,Sep,25027,24313,714,2.9,"Beltrami County, MN"
2024,Oct,24991,24346,645,2.6,"Beltrami County, MN"
2024,Nov,25071(P),24261(P),810(P),3.2(P),"Beltrami County, MN"
P : Preliminary.,P : Preliminary.,P : Preliminary.,P : Preliminary.,P : Preliminary.,P : Preliminary.,"Beltrami County, MN"
2014,Jan,21743,20174,1569,7.2,"Benton County, MN"
2014,Feb,21871,20345,1526,7.0,"Benton County, MN"
2014,Mar,21917,20273,1644,7.5,"Benton County, MN"
2014,Apr,21795,20629,1166,5.3,"Benton County, MN"
2014,May,21666,20692,974,4.5,"Benton County, MN"
2014,Jun,21669,20642,1027,4.7,"Benton County, MN"
2014,Jul,21812,20831,981,4.5,"Benton County, MN"
2014,Aug,21585,20691,894,4.1,"Benton County, MN"
2014,Sep,21643,20794,849,3.9,"Benton County, MN"
2014,Oct,21754,20986,768,3.5,"Benton County, MN"
2014,Nov,21851,20879,972,4.4,"Benton County, MN"
2014,Dec,21851,20725,1126,5.2,"Benton County, MN"
2015,Jan,21680,20319,1361,6.3,"Benton County, MN"
2015,Feb,21744,20435,1309,6.0,"Benton County, MN"
2015,Mar,21835,20559,1276,5.8,"Benton County, MN"
2015,Apr,21671,20723,948,4.4,"Benton County, MN"
2015,May,21614,20733,881,4.1,"Benton County, MN"
2015,Jun,21552,20596,956,4.4,"Benton County, MN"
2015,Jul,21560,20693,867,4.0,"Benton County, MN"
2015,Aug,21438,20630,808,3.8,"Benton County, MN"
2015,Sep,21424,20686,738,3.4,"Benton County, MN"
2015,Oct,21670,20944,726,3.4,"Benton County, MN"
2015,Nov,21729,20879,850,3.9,"Benton County, MN"
2015,Dec,21801,20743,1058,4.9,"Benton County, MN"
2016,Jan,21768,20488,1280,5.9,"Benton County, MN"
2016,Feb,21896,20617,1279,5.8,"Benton County, MN"
2016,Mar,21967,20669,1298,5.9,"Benton County, MN"
2016,Apr,21809,20874,935,4.3,"Benton County, MN"
2016,May,21650,20850,800,3.7,"Benton County, MN"
2016,Jun,21513,20626,887,4.1,"Benton County, MN"
2016,Jul,21658,20802,856,4.0,"Benton County, MN"
2016,Aug,21600,20793,807,3.7,"Benton County, MN"
2016,Sep,21640,20886,754,3.5,"Benton County, MN"
2016,Oct,21883,21150,733,3.3,"Benton County, MN"
2016,Nov,21868,21089,779,3.6,"Benton County, MN"
2016,Dec,21918,20797,1121,5.1,"Benton County, MN"
2017,Jan,21926,20556,1370,6.2,"Benton County, MN"
2017,Feb,21975,20719,1256,5.7,"Benton County, MN"
2017,Mar,22122,20918,1204,5.4,"Benton County, MN"
2017,Apr,22035,21118,917,4.2,"Benton County, MN"
2017,May,21803,21055,748,3.4,"Benton County, MN"
2017,Jun,21732,20923,809,3.7,"Benton County, MN"
2017,Jul,21760,20992,768,3.5,"Benton County, MN"
2017,Aug,21612,20870,742,3.4,"Benton County, MN"
2017,Sep,21692,21076,616,2.8,"Benton County, MN"
2017,Oct,21776,21172,604,2.8,"Benton County, MN"
2017,Nov,21789,21085,704,3.2,"Benton County, MN"
2017,Dec,21803,20826,977,4.5,"Benton County, MN"
2018,Jan,21869,20663,1206,5.5,"Benton County, MN"
2018,Feb,22115,20971,1144,5.2,"Benton County, MN"
2018,Mar,22043,20942,1101,5.0,"Benton County, MN"
2018,Apr,21935,21089,846,3.9,"Benton County, MN"
2018,May,21811,21217,594,2.7,"Benton County, MN"
2018,Jun,21701,21026,675,3.1,"Benton County, MN"
2018,Jul,21754,21157,597,2.7,"Benton County, MN"
2018,Aug,21509,20887,622,2.9,"Benton County, MN"
2018,Sep,21755,21229,526,2.4,"Benton County, MN"
2018,Oct,21906,21370,536,2.4,"Benton County, MN"
2018,Nov,21936,21335,601,2.7,"Benton County, MN"
2018,Dec,22060,21098,962,4.4,"Benton County, MN"
2019,Jan,22141,20837,1304,5.9,"Benton County, MN"
2019,Feb,22273,21064,1209,5.4,"Benton County, MN"
2019,Mar,22203,21032,1171,5.3,"Benton County, MN"
2019,Apr,22113,21245,868,3.9,"Benton County, MN"
2019,May,21959,21297,662,3.0,"Benton County, MN"
2019,Jun,21815,21063,752,3.4,"Benton County, MN"
2019,Jul,21985,21285,700,3.2,"Benton County, MN"
2019,Aug,21821,21130,691,3.2,"Benton County, MN"
2019,Sep,22073,21437,636,2.9,"Benton County, MN"
2019,Oct,22193,21546,647,2.9,"Benton County, MN"
2019,Nov,22096,21361,735,3.3,"Benton County, MN"
2019,Dec,22250,21178,1072,4.8,"Benton County, MN"
2020,Jan,22257,20977,1280,5.8,"Benton County, MN"
2020,Feb,22383,21170,1213,5.4,"Benton County, MN"
2020,Mar,22299,20845,1454,6.5,"Benton County, MN"
2020,Apr,21695,19611,2084,9.6,"Benton County, MN"
2020,May,21750,19311,2439,11.2,"Benton County, MN"
2020,Jun,22323,20404,1919,8.6,"Benton County, MN"
2020,Jul,22261,20678,1583,7.1,"Benton County, MN"
2020,Aug,22214,21010,1204,5.4,"Benton County, MN"
2020,Sep,22250,21135,1115,5.0,"Benton County, MN"
2020,Oct,22471,21383,1088,4.8,"Benton County, MN"
2020,Nov,22278,21140,1138,5.1,"Benton County, MN"
2020,Dec,21883,20531,1352,6.2,"Benton County, MN"
2021,Jan,21794,20244,1550,7.1,"Benton County, MN"
2021,Feb,21906,20436,1470,6.7,"Benton County, MN"
2021,Mar,21805,20422,1383,6.3,"Benton County, MN"
2021,Apr,21702,20601,1101,5.1,"Benton County, MN"
2021,May,21538,20585,953,4.4,"Benton County, MN"
2021,Jun,21232,20207,1025,4.8,"Benton County, MN"
2021,Jul,21364,20483,881,4.1,"Benton County, MN"
2021,Aug,21126,20311,815,3.9,"Benton County, MN"
2021,Sep,21352,20660,692,3.2,"Benton County, MN"
2021,Oct,21408,20778,630,2.9,"Benton County, MN"
2021,Nov,21381,20785,596,2.8,"Benton County, MN"
2021,Dec,21475,20626,849,4.0,"Benton County, MN"
2022,Jan,21647,20538,1109,5.1,"Benton County, MN"
2022,Feb,21699,20720,979,4.5,"Benton County, MN"
2022,Mar,21645,20749,896,4.1,"Benton County, MN"
2022,Apr,21578,20935,643,3.0,"Benton County, MN"
2022,May,21495,20963,532,2.5,"Benton County, MN"
2022,Jun,21219,20591,628,3.0,"Benton County, MN"
2022,Jul,21437,20879,558,2.6,"Benton County, MN"
2022,Aug,21420,20821,599,2.8,"Benton County, MN"
2022,Sep,21605,21128,477,2.2,"Benton County, MN"
2022,Oct,21684,21189,495,2.3,"Benton County, MN"
2022,Nov,21495,20878,617,2.9,"Benton County, MN"
2022,Dec,21879,20934,945,4.3,"Benton County, MN"
2023,Jan,21877,20756,1121,5.1,"Benton County, MN"
2023,Feb,22022,20883,1139,5.2,"Benton County, MN"
2023,Mar,22068,21022,1046,4.7,"Benton County, MN"
2023,Apr,21923,21099,824,3.8,"Benton County, MN"
2023,May,21757,21123,634,2.9,"Benton County, MN"
2023,Jun,21735,20876,859,4.0,"Benton County, MN"
2023,Jul,21747,20958,789,3.6,"Benton County, MN"
2023,Aug,21820,20986,834,3.8,"Benton County, MN"
2023,Sep,21724,21246,478,2.2,"Benton County, MN"
2023,Oct,21745,21277,468,2.2,"Benton County, MN"
2023,Nov,21739,21246,493,2.3,"Benton County, MN"
2023,Dec,21767,20996,771,3.5,"Benton County, MN"
2024,Jan,21957,20940,1017,4.6,"Benton County, MN"
2024,Feb,22011,20947,1064,4.8,"Benton County, MN"
2024,Mar,22104,21146,958,4.3,"Benton County, MN"
2024,Apr,21940,21199,741,3.4,"Benton County, MN"
2024,May,21730,20976,754,3.5,"Benton County, MN"
2024,Jun,21794,20785,1009,4.6,"Benton County, MN"
2024,Jul,22020,21008,1012,4.6,"Benton County, MN"
2024,Aug,22081,21068,1013,4.6,"Benton County, MN"
2024,Sep,21970,21319,651,3.0,"Benton County, MN"
2024,Oct,22017,21393,624,2.8,"Benton County, MN"
2024,Nov,22065(P),21267(P),798(P),3.6(P),"Benton County, MN"
P : Preliminary.,P : Preliminary.,P : Preliminary.,P : Preliminary.,P : Preliminary.,P : Preliminary.,"Benton County, MN"
2014,Jan,2496,2314,182,7.3,"Big Stone County, MN"
2014,Feb,2471,2300,171,6.9,"Big Stone County, MN"
2014,Mar,2542,2379,163,6.4,"Big Stone County, MN"
2014,Apr,2510,2384,126,5.0,"Big Stone County, MN"
2014,May,2575,2479,96,3.7,"Big Stone County, MN"
2014,Jun,2658,2554,104,3.9,"Big Stone County, MN"
2014,Jul,2723,2624,99,3.6,"Big Stone County, MN"
2014,Aug,2703,2613,90,3.3,"Big Stone County, MN"
2014,Sep,2606,2534,72,2.8,"Big Stone County, MN"
2014,Oct,2673,2604,69,2.6,"Big Stone County, MN"
2014,Nov,2596,2501,95,3.7,"Big Stone County, MN"
2014,Dec,2628,2483,145,5.5,"Big Stone County, MN"
2015,Jan,2710,2535,175,6.5,"Big Stone County, MN"
2015,Feb,2596,2439,157,6.0,"Big Stone County, MN"
2015,Mar,2700,2534,166,6.1,"Big Stone County, MN"
2015,Apr,2613,2508,105,4.0,"Big Stone County, MN"
2015,May,2663,2567,96,3.6,"Big Stone County, MN"
2015,Jun,2795,2686,109,3.9,"Big Stone County, MN"
2015,Jul,2751,2643,108,3.9,"Big Stone County, MN"
2015,Aug,2678,2571,107,4.0,"Big Stone County, MN"
2015,Sep,2631,2546,85,3.2,"Big Stone County, MN"
2015,Oct,2763,2678,85,3.1,"Big Stone County, MN"
2015,Nov,2679,2577,102,3.8,"Big Stone County, MN"
2015,Dec,2682,2515,167,6.2,"Big Stone County, MN"
2016,Jan,2767,2565,202,7.3,"Big Stone County, MN"
2016,Feb,2658,2477,181,6.8,"Big Stone County, MN"
2016,Mar,2744,2553,191,7.0,"Big Stone County, MN"
2016,Apr,2690,2570,120,4.5,"Big Stone County, MN"
2016,May,2700,2606,94,3.5,"Big Stone County, MN"
2016,Jun,2773,2659,114,4.1,"Big Stone County, MN"
2016,Jul,2742,2632,110,4.0,"Big Stone County, MN"
2016,Aug,2664,2560,104,3.9,"Big Stone County, MN"
2016,Sep,2601,2515,86,3.3,"Big Stone County, MN"
2016,Oct,2726,2634,92,3.4,"Big Stone County, MN"
2016,Nov,2690,2583,107,4.0,"Big Stone County, MN"
2016,Dec,2673,2512,161,6.0,"Big Stone County, MN"
2017,Jan,2655,2453,202,7.6,"Big Stone County, MN"
2017,Feb,2573,2405,168,6.5,"Big Stone County, MN"
2017,Mar,2605,2446,159,6.1,"Big Stone County, MN"
2017,Apr,2562,2443,119,4.6,"Big Stone County, MN"
2017,May,2557,2470,87,3.4,"Big Stone County, MN"
2017,Jun,2648,2551,97,3.7,"Big Stone County, MN"
2017,Jul,2600,2509,91,3.5,"Big Stone County, MN"
2017,Aug,2517,2430,87,3.5,"Big Stone County, MN"
2017,Sep,2522,2442,80,3.2,"Big Stone County, MN"
2017,Oct,2638,2571,67,2.5,"Big Stone County, MN"
2017,Nov,2571,2480,91,3.5,"Big Stone County, MN"
2017,Dec,2538,2406,132,5.2,"Big Stone County, MN"
2018,Jan,2469,2304,165,6.7,"Big Stone County, MN"
2018,Feb,2485,2336,149,6.0,"Big Stone County, MN"
2018,Mar,2456,2305,151,6.1,"Big Stone County, MN"
2018,Apr,2513,2408,105,4.2,"Big Stone County, MN"
2018,May,2620,2561,59,2.3,"Big Stone County, MN"
2018,Jun,2666,2594,72,2.7,"Big Stone County, MN"
2018,Jul,2562,2488,74,2.9,"Big Stone County, MN"
2018,Aug,2412,2351,61,2.5,"Big Stone County, MN"
2018,Sep,2446,2387,59,2.4,"Big Stone County, MN"
2018,Oct,2523,2457,66,2.6,"Big Stone County, MN"
2018,Nov,2442,2370,72,2.9,"Big Stone County, MN"
2018,Dec,2467,2324,143,5.8,"Big Stone County, MN"
2019,Jan,2435,2254,181,7.4,"Big Stone County, MN"
2019,Feb,2419,2263,156,6.4,"Big Stone County, MN"
2019,Mar,2411,2251,160,6.6,"Big Stone County, MN"
2019,Apr,2429,2317,112,4.6,"Big Stone County, MN"
2019,May,2569,2494,75,2.9,"Big Stone County, MN"
2019,Jun,2583,2499,84,3.3,"Big Stone County, MN"
2019,Jul,2625,2544,81,3.1,"Big Stone County, MN"
2019,Aug,2485,2419,66,2.7,"Big Stone County, MN"
2019,Sep,2510,2453,57,2.3,"Big Stone County, MN"
2019,Oct,2581,2526,55,2.1,"Big Stone County, MN"
2019,Nov,2485,2402,83,3.3,"Big Stone County, MN"
2019,Dec,2454,2308,146,5.9,"Big Stone County, MN"
2020,Jan,2492,2305,187,7.5,"Big Stone County, MN"
2020,Feb,2484,2329,155,6.2,"Big Stone County, MN"
2020,Mar,2461,2273,188,7.6,"Big Stone County, MN"
2020,Apr,2443,2280,163,6.7,"Big Stone County, MN"
2020,May,2500,2354,146,5.8,"Big Stone County, MN"
2020,Jun,2608,2474,134,5.1,"Big Stone County, MN"
2020,Jul,2701,2606,95,3.5,"Big Stone County, MN"
2020,Aug,2602,2522,80,3.1,"Big Stone County, MN"
2020,Sep,2576,2508,68,2.6,"Big Stone County, MN"
2020,Oct,2680,2612,68,2.5,"Big Stone County, MN"
2020,Nov,2554,2483,71,2.8,"Big Stone County, MN"
2020,Dec,2540,2427,113,4.4,"Big Stone County, MN"
2021,Jan,2478,2317,161,6.5,"Big Stone County, MN"
2021,Feb,2442,2302,140,5.7,"Big Stone County, MN"
2021,Mar,2387,2249,138,5.8,"Big Stone County, MN"
2021,Apr,2383,2290,93,3.9,"Big Stone County, MN"
2021,May,2427,2350,77,3.2,"Big Stone County, MN"
2021,Jun,2476,2388,88,3.6,"Big Stone County, MN"
2021,Jul,2604,2524,80,3.1,"Big Stone County, MN"
2021,Aug,2518,2441,77,3.1,"Big Stone County, MN"
2021,Sep,2446,2378,68,2.8,"Big Stone County, MN"
2021,Oct,2485,2436,49,2.0,"Big Stone County, MN"
2021,Nov,2403,2354,49,2.0,"Big Stone County, MN"
2021,Dec,2434,2355,79,3.2,"Big Stone County, MN"
2022,Jan,2415,2298,117,4.8,"Big Stone County, MN"
2022,Feb,2372,2266,106,4.5,"Big Stone County, MN"
2022,Mar,2344,2241,103,4.4,"Big Stone County, MN"
2022,Apr,2304,2231,73,3.2,"Big Stone County, MN"
2022,May,2390,2332,58,2.4,"Big Stone County, MN"
2022,Jun,2425,2356,69,2.8,"Big Stone County, MN"
2022,Jul,2496,2433,63,2.5,"Big Stone County, MN"
2022,Aug,2435,2369,66,2.7,"Big Stone County, MN"
2022,Sep,2380,2332,48,2.0,"Big Stone County, MN"
2022,Oct,2446,2401,45,1.8,"Big Stone County, MN"
2022,Nov,2348,2298,50,2.1,"Big Stone County, MN"
2022,Dec,2390,2286,104,4.4,"Big Stone County, MN"
2023,Jan,2372,2255,117,4.9,"Big Stone County, MN"
2023,Feb,2394,2278,116,4.8,"Big Stone County, MN"
2023,Mar,2310,2210,100,4.3,"Big Stone County, MN"
2023,Apr,2317,2236,81,3.5,"Big Stone County, MN"
2023,May,2372,2317,55,2.3,"Big Stone County, MN"
2023,Jun,2443,2344,99,4.1,"Big Stone County, MN"
2023,Jul,2434,2342,92,3.8,"Big Stone County, MN"
2023,Aug,2498,2404,94,3.8,"Big Stone County, MN"
2023,Sep,2443,2386,57,2.3,"Big Stone County, MN"
2023,Oct,2469,2419,50,2.0,"Big Stone County, MN"
2023,Nov,2413,2370,43,1.8,"Big Stone County, MN"
2023,Dec,2322,2252,70,3.0,"Big Stone County, MN"
2024,Jan,2345,2226,119,5.1,"Big Stone County, MN"
2024,Feb,2326,2206,120,5.2,"Big Stone County, MN"
2024,Mar,2363,2262,101,4.3,"Big Stone County, MN"
2024,Apr,2371,2295,76,3.2,"Big Stone County, MN"
2024,May,2358,2288,70,3.0,"Big Stone County, MN"
2024,Jun,2482,2375,107,4.3,"Big Stone County, MN"
2024,Jul,2530,2419,111,4.4,"Big Stone County, MN"
2024,Aug,2609,2504,105,4.0,"Big Stone County, MN"
2024,Sep,2554,2488,66,2.6,"Big Stone County, MN"
2024,Oct,2531,2472,59,2.3,"Big Stone County, MN"
2024,Nov,2482(P),2421(P),61(P),2.5(P),"Big Stone County, MN"
P : Preliminary.,P : Preliminary.,P : Preliminary.,P : Preliminary.,P : Preliminary.,P : Preliminary.,"Big Stone County, MN"
2014,Jan,38480,36797,1683,4.4,"Blue Earth County, MN"
2014,Feb,38923,37213,1710,4.4,"Blue Earth County, MN"
2014,Mar,38788,37122,1666,4.3,"Blue Earth County, MN"
2014,Apr,38598,37235,1363,3.5,"Blue Earth County, MN"
2014,May,38558,37276,1282,3.3,"Blue Earth County, MN"
2014,Jun,38562,37093,1469,3.8,"Blue Earth County, MN"
2014,Jul,38081,36654,1427,3.7,"Blue Earth County, MN"
2014,Aug,37716,36414,1302,3.5,"Blue Earth County, MN"
2014,Sep,38428,37265,1163,3.0,"Blue Earth County, MN"
2014,Oct,39350,38293,1057,2.7,"Blue Earth County, MN"
2014,Nov,39048,38021,1027,2.6,"Blue Earth County, MN"
2014,Dec,38881,37713,1168,3.0,"Blue Earth County, MN"
2015,Jan,38770,37294,1476,3.8,"Blue Earth County, MN"
2015,Feb,39191,37761,1430,3.6,"Blue Earth County, MN"
2015,Mar,39204,37815,1389,3.5,"Blue Earth County, MN"
2015,Apr,39914,38799,1115,2.8,"Blue Earth County, MN"
2015,May,39574,38425,1149,2.9,"Blue Earth County, MN"
2015,Jun,38846,37562,1284,3.3,"Blue Earth County, MN"
2015,Jul,38459,37216,1243,3.2,"Blue Earth County, MN"
2015,Aug,38439,37321,1118,2.9,"Blue Earth County, MN"
2015,Sep,39502,38491,1011,2.6,"Blue Earth County, MN"
2015,Oct,40917,39875,1042,2.5,"Blue Earth County, MN"
2015,Nov,40603,39682,921,2.3,"Blue Earth County, MN"
2015,Dec,40169,39080,1089,2.7,"Blue Earth County, MN"
2016,Jan,39817,38388,1429,3.6,"Blue Earth County, MN"
2016,Feb,40271,38813,1458,3.6,"Blue Earth County, MN"
2016,Mar,40297,38803,1494,3.7,"Blue Earth County, MN"
2016,Apr,39877,38698,1179,3.0,"Blue Earth County, MN"
2016,May,39449,38344,1105,2.8,"Blue Earth County, MN"
2016,Jun,38826,37390,1436,3.7,"Blue Earth County, MN"
2016,Jul,38422,37082,1340,3.5,"Blue Earth County, MN"
2016,Aug,38441,37196,1245,3.2,"Blue Earth County, MN"
2016,Sep,39489,38338,1151,2.9,"Blue Earth County, MN"
2016,Oct,40578,39469,1109,2.7,"Blue Earth County, MN"
2016,Nov,39994,38972,1022,2.6,"Blue Earth County, MN"
2016,Dec,39671,38402,1269,3.2,"Blue Earth County, MN"
2017,Jan,39768,38242,1526,3.8,"Blue Earth County, MN"
2017,Feb,40184,38650,1534,3.8,"Blue Earth County, MN"
2017,Mar,40380,38986,1394,3.5,"Blue Earth County, MN"
2017,Apr,40583,39437,1146,2.8,"Blue Earth County, MN"
2017,May,40005,38866,1139,2.8,"Blue Earth County, MN"
2017,Jun,40043,38685,1358,3.4,"Blue Earth County, MN"
2017,Jul,39194,38004,1190,3.0,"Blue Earth County, MN"
2017,Aug,39164,38025,1139,2.9,"Blue Earth County, MN"
2017,Sep,40513,39534,979,2.4,"Blue Earth County, MN"
2017,Oct,41392,40540,852,2.1,"Blue Earth County, MN"
2017,Nov,40809,39928,881,2.2,"Blue Earth County, MN"
2017,Dec,40448,39377,1071,2.6,"Blue Earth County, MN"
2018,Jan,40160,38848,1312,3.3,"Blue Earth County, MN"
2018,Feb,40703,39414,1289,3.2,"Blue Earth County, MN"
2018,Mar,40750,39474,1276,3.1,"Blue Earth County, MN"
2018,Apr,40538,39535,1003,2.5,"Blue Earth County, MN"
2018,May,40321,39427,894,2.2,"Blue Earth County, MN"
2018,Jun,40004,38837,1167,2.9,"Blue Earth County, MN"
2018,Jul,39272,38289,983,2.5,"Blue Earth County, MN"
2018,Aug,38881,37932,949,2.4,"Blue Earth County, MN"
2018,Sep,40409,39509,900,2.2,"Blue Earth County, MN"
2018,Oct,41382,40553,829,2.0,"Blue Earth County, MN"
2018,Nov,40860,40080,780,1.9,"Blue Earth County, MN"
2018,Dec,40904,39759,1145,2.8,"Blue Earth County, MN"
2019,Jan,40431,39081,1350,3.3,"Blue Earth County, MN"
2019,Feb,40795,39474,1321,3.2,"Blue Earth County, MN"
2019,Mar,40813,39477,1336,3.3,"Blue Earth County, MN"
2019,Apr,40987,39914,1073,2.6,"Blue Earth County, MN"
2019,May,40895,39793,1102,2.7,"Blue Earth County, MN"
2019,Jun,40516,39198,1318,3.3,"Blue Earth County, MN"
2019,Jul,39660,38463,1197,3.0,"Blue Earth County, MN"
2019,Aug,39926,38730,1196,3.0,"Blue Earth County, MN"
2019,Sep,41230,40223,1007,2.4,"Blue Earth County, MN"
2019,Oct,42103,41181,922,2.2,"Blue Earth County, MN"
2019,Nov,41503,40647,856,2.1,"Blue Earth County, MN"
2019,Dec,41365,40289,1076,2.6,"Blue Earth County, MN"
2020,Jan,41011,39734,1277,3.1,"Blue Earth County, MN"
2020,Feb,41501,40197,1304,3.1,"Blue Earth County, MN"
2020,Mar,41090,39404,1686,4.1,"Blue Earth County, MN"
2020,Apr,39487,36341,3146,8.0,"Blue Earth County, MN"
2020,May,39683,35674,4009,10.1,"Blue Earth County, MN"
2020,Jun,40871,37491,3380,8.3,"Blue Earth County, MN"
2020,Jul,40256,37360,2896,7.2,"Blue Earth County, MN"
2020,Aug,40386,38106,2280,5.6,"Blue Earth County, MN"
2020,Sep,41059,39114,1945,4.7,"Blue Earth County, MN"
2020,Oct,42400,40840,1560,3.7,"Blue Earth County, MN"
2020,Nov,41378,39936,1442,3.5,"Blue Earth County, MN"
2020,Dec,40636,38907,1729,4.3,"Blue Earth County, MN"
2021,Jan,40132,38300,1832,4.6,"Blue Earth County, MN"
2021,Feb,40421,38746,1675,4.1,"Blue Earth County, MN"
2021,Mar,40174,38552,1622,4.0,"Blue Earth County, MN"
2021,Apr,40037,38652,1385,3.5,"Blue Earth County, MN"
2021,May,39730,38377,1353,3.4,"Blue Earth County, MN"
2021,Jun,39371,37764,1607,4.1,"Blue Earth County, MN"
2021,Jul,38457,37113,1344,3.5,"Blue Earth County, MN"
2021,Aug,38231,36932,1299,3.4,"Blue Earth County, MN"
2021,Sep,39270,38184,1086,2.8,"Blue Earth County, MN"
2021,Oct,40547,39618,929,2.3,"Blue Earth County, MN"
2021,Nov,40314,39505,809,2.0,"Blue Earth County, MN"
2021,Dec,40267,39318,949,2.4,"Blue Earth County, MN"
2022,Jan,40182,39031,1151,2.9,"Blue Earth County, MN"
2022,Feb,40591,39562,1029,2.5,"Blue Earth County, MN"
2022,Mar,40630,39645,985,2.4,"Blue Earth County, MN"
2022,Apr,40342,39632,710,1.8,"Blue Earth County, MN"
2022,May,39806,39102,704,1.8,"Blue Earth County, MN"
2022,Jun,39471,38492,979,2.5,"Blue Earth County, MN"
2022,Jul,39066,38197,869,2.2,"Blue Earth County, MN"
2022,Aug,39288,38407,881,2.2,"Blue Earth County, MN"
2022,Sep,40514,39884,630,1.6,"Blue Earth County, MN"
2022,Oct,41460,40786,674,1.6,"Blue Earth County, MN"
2022,Nov,40899,40162,737,1.8,"Blue Earth County, MN"
2022,Dec,40979,39964,1015,2.5,"Blue Earth County, MN"
2023,Jan,40646,39521,1125,2.8,"Blue Earth County, MN"
2023,Feb,41212,40023,1189,2.9,"Blue Earth County, MN"
2023,Mar,41355,40228,1127,2.7,"Blue Earth County, MN"
2023,Apr,41387,40446,941,2.3,"Blue Earth County, MN"
2023,May,40888,39984,904,2.2,"Blue Earth County, MN"
2023,Jun,40667,39555,1112,2.7,"Blue Earth County, MN"
2023,Jul,40560,39516,1044,2.6,"Blue Earth County, MN"
2023,Aug,40387,39339,1048,2.6,"Blue Earth County, MN"
2023,Sep,40914,40164,750,1.8,"Blue Earth County, MN"
2023,Oct,41411,40716,695,1.7,"Blue Earth County, MN"
2023,Nov,41011,40412,599,1.5,"Blue Earth County, MN"
2023,Dec,40492,39677,815,2.0,"Blue Earth County, MN"
2024,Jan,40790,39700,1090,2.7,"Blue Earth County, MN"
2024,Feb,41082,39803,1279,3.1,"Blue Earth County, MN"
2024,Mar,41369,40312,1057,2.6,"Blue Earth County, MN"
2024,Apr,41315,40408,907,2.2,"Blue Earth County, MN"
2024,May,40630,39672,958,2.4,"Blue Earth County, MN"
2024,Jun,41103,39686,1417,3.4,"Blue Earth County, MN"
2024,Jul,41160,39776,1384,3.4,"Blue Earth County, MN"
2024,Aug,41487,40106,1381,3.3,"Blue Earth County, MN"
2024,Sep,42294,41345,949,2.2,"Blue Earth County, MN"
2024,Oct,42980,42130,850,2.0,"Blue Earth County, MN"
2024,Nov,42172(P),41207(P),965(P),2.3(P),"Blue Earth County, MN"
P : Preliminary.,P : Preliminary.,P : Preliminary.,P : Preliminary.,P : Preliminary.,P : Preliminary.,"Blue Earth County, MN"
2014,Jan,14116,13168,948,6.7,"Brown County, MN"
2014,Feb,14144,13205,939,6.6,"Brown County, MN"
2014,Mar,14162,13216,946,6.7,"Brown County, MN"
2014,Apr,13979,13254,725,5.2,"Brown County, MN"
2014,May,14079,13465,614,4.4,"Brown County, MN"
2014,Jun,14205,13568,637,4.5,"Brown County, MN"
2014,Jul,14401,13811,590,4.1,"Brown County, MN"
2014,Aug,14371,13839,532,3.7,"Brown County, MN"
2014,Sep,14084,13614,470,3.3,"Brown County, MN"
2014,Oct,14514,14075,439,3.0,"Brown County, MN"
2014,Nov,14363,13882,481,3.3,"Brown County, MN"
2014,Dec,14278,13635,643,4.5,"Brown County, MN"
2015,Jan,14614,13791,823,5.6,"Brown County, MN"
2015,Feb,14420,13635,785,5.4,"Brown County, MN"
2015,Mar,14691,13847,844,5.7,"Brown County, MN"
2015,Apr,14564,13976,588,4.0,"Brown County, MN"
2015,May,14585,13997,588,4.0,"Brown County, MN"
2015,Jun,15009,14379,630,4.2,"Brown County, MN"
2015,Jul,14755,14179,576,3.9,"Brown County, MN"
2015,Aug,14641,14139,502,3.4,"Brown County, MN"
2015,Sep,14501,14058,443,3.1,"Brown County, MN"
2015,Oct,14834,14387,447,3.0,"Brown County, MN"
2015,Nov,14634,14144,490,3.3,"Brown County, MN"
2015,Dec,14619,13986,633,4.3,"Brown County, MN"
2016,Jan,14705,13913,792,5.4,"Brown County, MN"
2016,Feb,14418,13662,756,5.2,"Brown County, MN"
2016,Mar,14584,13798,786,5.4,"Brown County, MN"
2016,Apr,14468,13875,593,4.1,"Brown County, MN"
2016,May,14318,13767,551,3.8,"Brown County, MN"
2016,Jun,14678,14067,611,4.2,"Brown County, MN"
2016,Jul,14462,13891,571,3.9,"Brown County, MN"
2016,Aug,14512,13958,554,3.8,"Brown County, MN"
2016,Sep,14289,13789,500,3.5,"Brown County, MN"
2016,Oct,14643,14161,482,3.3,"Brown County, MN"
2016,Nov,14624,14148,476,3.3,"Brown County, MN"
2016,Dec,14439,13813,626,4.3,"Brown County, MN"
2017,Jan,14705,13820,885,6.0,"Brown County, MN"
2017,Feb,14520,13742,778,5.4,"Brown County, MN"
2017,Mar,14669,13897,772,5.3,"Brown County, MN"
2017,Apr,14605,14016,589,4.0,"Brown County, MN"
2017,May,14485,14001,484,3.3,"Brown County, MN"
2017,Jun,14665,14144,521,3.6,"Brown County, MN"
2017,Jul,14380,13923,457,3.2,"Brown County, MN"
2017,Aug,14220,13784,436,3.1,"Brown County, MN"
2017,Sep,14247,13886,361,2.5,"Brown County, MN"
2017,Oct,14377,14056,321,2.2,"Brown County, MN"
2017,Nov,14229,13852,377,2.6,"Brown County, MN"
2017,Dec,14254,13738,516,3.6,"Brown County, MN"
2018,Jan,14442,13697,745,5.2,"Brown County, MN"
2018,Feb,14539,13838,701,4.8,"Brown County, MN"
2018,Mar,14595,13878,717,4.9,"Brown County, MN"
2018,Apr,14523,13977,546,3.8,"Brown County, MN"
2018,May,14657,14213,444,3.0,"Brown County, MN"
2018,Jun,14787,14326,461,3.1,"Brown County, MN"
2018,Jul,14598,14181,417,2.9,"Brown County, MN"
2018,Aug,14260,13886,374,2.6,"Brown County, MN"
2018,Sep,14411,14066,345,2.4,"Brown County, MN"
2018,Oct,14481,14128,353,2.4,"Brown County, MN"
2018,Nov,14363,14004,359,2.5,"Brown County, MN"
2018,Dec,14275,13718,557,3.9,"Brown County, MN"
2019,Jan,14235,13406,829,5.8,"Brown County, MN"
2019,Feb,14160,13448,712,5.0,"Brown County, MN"
2019,Mar,14167,13450,717,5.1,"Brown County, MN"
2019,Apr,14420,13900,520,3.6,"Brown County, MN"
2019,May,14584,14137,447,3.1,"Brown County, MN"
2019,Jun,14595,14109,486,3.3,"Brown County, MN"
2019,Jul,14640,14168,472,3.2,"Brown County, MN"
2019,Aug,14460,14029,431,3.0,"Brown County, MN"
2019,Sep,14494,14126,368,2.5,"Brown County, MN"
2019,Oct,14776,14406,370,2.5,"Brown County, MN"
2019,Nov,14387,13980,407,2.8,"Brown County, MN"
2019,Dec,14444,13866,578,4.0,"Brown County, MN"
2020,Jan,14246,13485,761,5.3,"Brown County, MN"
2020,Feb,14258,13546,712,5.0,"Brown County, MN"
2020,Mar,14183,13289,894,6.3,"Brown County, MN"
2020,Apr,13841,12917,924,6.7,"Brown County, MN"
2020,May,14066,12924,1142,8.1,"Brown County, MN"
2020,Jun,14628,13704,924,6.3,"Brown County, MN"
2020,Jul,14548,13781,767,5.3,"Brown County, MN"
2020,Aug,14390,13790,600,4.2,"Brown County, MN"
2020,Sep,14260,13716,544,3.8,"Brown County, MN"
2020,Oct,14734,14238,496,3.4,"Brown County, MN"
2020,Nov,14234,13705,529,3.7,"Brown County, MN"
2020,Dec,14136,13489,647,4.6,"Brown County, MN"
2021,Jan,13763,13000,763,5.5,"Brown County, MN"
2021,Feb,13819,13106,713,5.2,"Brown County, MN"
2021,Mar,13792,13115,677,4.9,"Brown County, MN"
2021,Apr,13701,13222,479,3.5,"Brown County, MN"
2021,May,13782,13383,399,2.9,"Brown County, MN"
2021,Jun,13896,13417,479,3.4,"Brown County, MN"
2021,Jul,13845,13453,392,2.8,"Brown County, MN"
2021,Aug,13679,13298,381,2.8,"Brown County, MN"
2021,Sep,13690,13364,326,2.4,"Brown County, MN"
2021,Oct,13762,13488,274,2.0,"Brown County, MN"
2021,Nov,13617,13366,251,1.8,"Brown County, MN"
2021,Dec,13739,13393,346,2.5,"Brown County, MN"
2022,Jan,13989,13474,515,3.7,"Brown County, MN"
2022,Feb,14011,13521,490,3.5,"Brown County, MN"
2022,Mar,13958,13479,479,3.4,"Brown County, MN"
2022,Apr,13731,13425,306,2.2,"Brown County, MN"
2022,May,13803,13524,279,2.0,"Brown County, MN"
2022,Jun,13815,13455,360,2.6,"Brown County, MN"
2022,Jul,13826,13498,328,2.4,"Brown County, MN"
2022,Aug,13784,13460,324,2.4,"Brown County, MN"
2022,Sep,13604,13340,264,1.9,"Brown County, MN"
2022,Oct,13948,13709,239,1.7,"Brown County, MN"
2022,Nov,13782,13498,284,2.1,"Brown County, MN"
2022,Dec,13976,13567,409,2.9,"Brown County, MN"
2023,Jan,14083,13591,492,3.5,"Brown County, MN"
2023,Feb,14250,13671,579,4.1,"Brown County, MN"
2023,Mar,14237,13660,577,4.1,"Brown County, MN"
2023,Apr,13989,13557,432,3.1,"Brown County, MN"
2023,May,14002,13634,368,2.6,"Brown County, MN"
2023,Jun,14117,13633,484,3.4,"Brown County, MN"
2023,Jul,13763,13335,428,3.1,"Brown County, MN"
2023,Aug,14009,13574,435,3.1,"Brown County, MN"
2023,Sep,13932,13642,290,2.1,"Brown County, MN"
2023,Oct,14017,13759,258,1.8,"Brown County, MN"
2023,Nov,13869,13651,218,1.6,"Brown County, MN"
2023,Dec,13621,13283,338,2.5,"Brown County, MN"
2024,Jan,13777,13262,515,3.7,"Brown County, MN"
2024,Feb,13854,13255,599,4.3,"Brown County, MN"
2024,Mar,13974,13462,512,3.7,"Brown County, MN"
2024,Apr,13952,13542,410,2.9,"Brown County, MN"
2024,May,13749,13322,427,3.1,"Brown County, MN"
2024,Jun,14090,13500,590,4.2,"Brown County, MN"
2024,Jul,14020,13468,552,3.9,"Brown County, MN"
2024,Aug,14356,13804,552,3.8,"Brown County, MN"
2024,Sep,14223,13853,370,2.6,"Brown County, MN"
2024,Oct,14159,13849,310,2.2,"Brown County, MN"
2024,Nov,14111(P),13755(P),356(P),2.5(P),"Brown County, MN"
P : Preliminary.,P : Preliminary.,P : Preliminary.,P : Preliminary.,P : Preliminary.,P : Preliminary.,"Brown County, MN"
2014,Jan,17517,16315,1202,6.9,"Carlton County, MN"
2014,Feb,17702,16451,1251,7.1,"Carlton County, MN"
2014,Mar,17708,16472,1236,7.0,"Carlton County, MN"
2014,Apr,17571,16511,1060,6.0,"Carlton County, MN"
2014,May,17583,16642,941,5.4,"Carlton County, MN"
2014,Jun,17697,16764,933,5.3,"Carlton County, MN"
2014,Jul,17686,16802,884,5.0,"Carlton County, MN"
2014,Aug,17459,16661,798,4.6,"Carlton County, MN"
2014,Sep,17562,16827,735,4.2,"Carlton County, MN"
2014,Oct,17598,16929,669,3.8,"Carlton County, MN"
2014,Nov,17812,17041,771,4.3,"Carlton County, MN"
2014,Dec,17688,16822,866,4.9,"Carlton County, MN"
2015,Jan,17507,16449,1058,6.0,"Carlton County, MN"
2015,Feb,17658,16607,1051,6.0,"Carlton County, MN"
2015,Mar,17645,16568,1077,6.1,"Carlton County, MN"
2015,Apr,17687,16774,913,5.2,"Carlton County, MN"
2015,May,17720,16904,816,4.6,"Carlton County, MN"
2015,Jun,17721,16851,870,4.9,"Carlton County, MN"
2015,Jul,17753,16935,818,4.6,"Carlton County, MN"
2015,Aug,17492,16737,755,4.3,"Carlton County, MN"
2015,Sep,17521,16826,695,4.0,"Carlton County, MN"
2015,Oct,17536,16815,721,4.1,"Carlton County, MN"
2015,Nov,17574,16731,843,4.8,"Carlton County, MN"
2015,Dec,17594,16590,1004,5.7,"Carlton County, MN"
2016,Jan,17727,16579,1148,6.5,"Carlton County, MN"
2016,Feb,17930,16788,1142,6.4,"Carlton County, MN"
2016,Mar,17921,16713,1208,6.7,"Carlton County, MN"
2016,Apr,17845,16845,1000,5.6,"Carlton County, MN"
2016,May,17769,16957,812,4.6,"Carlton County, MN"
2016,Jun,17604,16688,916,5.2,"Carlton County, MN"
2016,Jul,17715,16854,861,4.9,"Carlton County, MN"
2016,Aug,17582,16746,836,4.8,"Carlton County, MN"
2016,Sep,17716,16949,767,4.3,"Carlton County, MN"
2016,Oct,17728,16946,782,4.4,"Carlton County, MN"
2016,Nov,17619,16809,810,4.6,"Carlton County, MN"
2016,Dec,17610,16617,993,5.6,"Carlton County, MN"
2017,Jan,17722,16494,1228,6.9,"Carlton County, MN"
2017,Feb,17892,16735,1157,6.5,"Carlton County, MN"
2017,Mar,17920,16780,1140,6.4,"Carlton County, MN"
2017,Apr,17889,16970,919,5.1,"Carlton County, MN"
2017,May,17710,16957,753,4.3,"Carlton County, MN"
2017,Jun,17758,16980,778,4.4,"Carlton County, MN"
2017,Jul,17769,17071,698,3.9,"Carlton County, MN"
2017,Aug,17600,16882,718,4.1,"Carlton County, MN"
2017,Sep,17847,17245,602,3.4,"Carlton County, MN"
2017,Oct,17683,17119,564,3.2,"Carlton County, MN"
2017,Nov,17768,17019,749,4.2,"Carlton County, MN"
2017,Dec,17751,16847,904,5.1,"Carlton County, MN"
2018,Jan,17853,16825,1028,5.8,"Carlton County, MN"
2018,Feb,18153,17148,1005,5.5,"Carlton County, MN"
2018,Mar,18128,17102,1026,5.7,"Carlton County, MN"
2018,Apr,18060,17204,856,4.7,"Carlton County, MN"
2018,May,17933,17247,686,3.8,"Carlton County, MN"
2018,Jun,17885,17133,752,4.2,"Carlton County, MN"
2018,Jul,17744,17112,632,3.6,"Carlton County, MN"
2018,Aug,17439,16859,580,3.3,"Carlton County, MN"
2018,Sep,17689,17180,509,2.9,"Carlton County, MN"
2018,Oct,17752,17248,504,2.8,"Carlton County, MN"
2018,Nov,17756,17153,603,3.4,"Carlton County, MN"
2018,Dec,17854,16983,871,4.9,"Carlton County, MN"
2019,Jan,17957,16895,1062,5.9,"Carlton County, MN"
2019,Feb,18174,17171,1003,5.5,"Carlton County, MN"
2019,Mar,18120,17113,1007,5.6,"Carlton County, MN"
2019,Apr,18064,17244,820,4.5,"Carlton County, MN"
2019,May,17964,17270,694,3.9,"Carlton County, MN"
2019,Jun,17926,17165,761,4.2,"Carlton County, MN"
2019,Jul,17880,17129,751,4.2,"Carlton County, MN"
2019,Aug,17698,16982,716,4.0,"Carlton County, MN"
2019,Sep,17862,17278,584,3.3,"Carlton County, MN"
2019,Oct,18027,17393,634,3.5,"Carlton County, MN"
2019,Nov,18035,17310,725,4.0,"Carlton County, MN"
2019,Dec,18129,17158,971,5.4,"Carlton County, MN"
2020,Jan,18128,17044,1084,6.0,"Carlton County, MN"
2020,Feb,18333,17291,1042,5.7,"Carlton County, MN"
2020,Mar,18248,17004,1244,6.8,"Carlton County, MN"
2020,Apr,17353,15488,1865,10.7,"Carlton County, MN"
2020,May,17242,15011,2231,12.9,"Carlton County, MN"
2020,Jun,17806,15999,1807,10.1,"Carlton County, MN"
2020,Jul,17822,16324,1498,8.4,"Carlton County, MN"
2020,Aug,17884,16685,1199,6.7,"Carlton County, MN"
2020,Sep,17978,16921,1057,5.9,"Carlton County, MN"
2020,Oct,17895,17043,852,4.8,"Carlton County, MN"
2020,Nov,17716,16889,827,4.7,"Carlton County, MN"
2020,Dec,17306,16343,963,5.6,"Carlton County, MN"
2021,Jan,17358,16322,1036,6.0,"Carlton County, MN"
2021,Feb,17530,16492,1038,5.9,"Carlton County, MN"
2021,Mar,17489,16530,959,5.5,"Carlton County, MN"
2021,Apr,17509,16651,858,4.9,"Carlton County, MN"
2021,May,17412,16681,731,4.2,"Carlton County, MN"
2021,Jun,17308,16525,783,4.5,"Carlton County, MN"
2021,Jul,17315,16659,656,3.8,"Carlton County, MN"
2021,Aug,17173,16552,621,3.6,"Carlton County, MN"
2021,Sep,17445,16859,586,3.4,"Carlton County, MN"
2021,Oct,17533,17006,527,3.0,"Carlton County, MN"
2021,Nov,17641,17077,564,3.2,"Carlton County, MN"
2021,Dec,17572,16845,727,4.1,"Carlton County, MN"
2022,Jan,17527,16664,863,4.9,"Carlton County, MN"
2022,Feb,17616,16836,780,4.4,"Carlton County, MN"
2022,Mar,17643,16912,731,4.1,"Carlton County, MN"
2022,Apr,17545,16961,584,3.3,"Carlton County, MN"
2022,May,17518,16982,536,3.1,"Carlton County, MN"
2022,Jun,17438,16877,561,3.2,"Carlton County, MN"
2022,Jul,17436,16940,496,2.8,"Carlton County, MN"
2022,Aug,17387,16889,498,2.9,"Carlton County, MN"
2022,Sep,17643,17227,416,2.4,"Carlton County, MN"
2022,Oct,17558,17109,449,2.6,"Carlton County, MN"
2022,Nov,17532,16988,544,3.1,"Carlton County, MN"
2022,Dec,17637,16857,780,4.4,"Carlton County, MN"
2023,Jan,17571,16712,859,4.9,"Carlton County, MN"
2023,Feb,17875,16984,891,5.0,"Carlton County, MN"
2023,Mar,17892,17025,867,4.8,"Carlton County, MN"
2023,Apr,17774,17015,759,4.3,"Carlton County, MN"
2023,May,17706,17066,640,3.6,"Carlton County, MN"
2023,Jun,17778,17074,704,4.0,"Carlton County, MN"
2023,Jul,17688,17069,619,3.5,"Carlton County, MN"
2023,Aug,17481,16872,609,3.5,"Carlton County, MN"
2023,Sep,17421,17001,420,2.4,"Carlton County, MN"
2023,Oct,17402,16993,409,2.4,"Carlton County, MN"
2023,Nov,17363,16954,409,2.4,"Carlton County, MN"
2023,Dec,17418,16799,619,3.6,"Carlton County, MN"
2024,Jan,17556,16740,816,4.6,"Carlton County, MN"
2024,Feb,17650,16815,835,4.7,"Carlton County, MN"
2024,Mar,17705,16929,776,4.4,"Carlton County, MN"
2024,Apr,17588,16931,657,3.7,"Carlton County, MN"
2024,May,17403,16752,651,3.7,"Carlton County, MN"
2024,Jun,17222,16459,763,4.4,"Carlton County, MN"
2024,Jul,17289,16534,755,4.4,"Carlton County, MN"
2024,Aug,17239,16472,767,4.4,"Carlton County, MN"
2024,Sep,17151,16628,523,3.0,"Carlton County, MN"
2024,Oct,17252,16777,475,2.8,"Carlton County, MN"
2024,Nov,17364(P),16754(P),610(P),3.5(P),"Carlton County, MN"
P : Preliminary.,P : Preliminary.,P : Preliminary.,P : Preliminary.,P : Preliminary.,P : Preliminary.,"Carlton County, MN"
2014,Jan,53753,51261,2492,4.6,"Carver County, MN"
2014,Feb,53812,51348,2464,4.6,"Carver County, MN"
2014,Mar,54018,51561,2457,4.5,"Carver County, MN"
2014,Apr,54095,52075,2020,3.7,"Carver County, MN"
2014,May,54360,52485,1875,3.4,"Carver County, MN"
2014,Jun,54821,52708,2113,3.9,"Carver County, MN"
2014,Jul,55141,53081,2060,3.7,"Carver County, MN"
2014,Aug,54668,52740,1928,3.5,"Carver County, MN"
2014,Sep,54371,52617,1754,3.2,"Carver County, MN"
2014,Oct,54621,53005,1616,3.0,"Carver County, MN"
2014,Nov,54604,52988,1616,3.0,"Carver County, MN"
2014,Dec,54479,52652,1827,3.4,"Carver County, MN"
2015,Jan,54723,52525,2198,4.0,"Carver County, MN"
2015,Feb,54832,52736,2096,3.8,"Carver County, MN"
2015,Mar,54843,52773,2070,3.8,"Carver County, MN"
2015,Apr,55163,53462,1701,3.1,"Carver County, MN"
2015,May,55622,53914,1708,3.1,"Carver County, MN"
2015,Jun,55737,53834,1903,3.4,"Carver County, MN"
2015,Jul,56040,54226,1814,3.2,"Carver County, MN"
2015,Aug,55538,53872,1666,3.0,"Carver County, MN"
2015,Sep,55058,53490,1568,2.8,"Carver County, MN"
2015,Oct,55294,53766,1528,2.8,"Carver County, MN"
2015,Nov,55318,53862,1456,2.6,"Carver County, MN"
2015,Dec,55443,53657,1786,3.2,"Carver County, MN"
2016,Jan,55684,53609,2075,3.7,"Carver County, MN"
2016,Feb,56027,53943,2084,3.7,"Carver County, MN"
2016,Mar,56017,53889,2128,3.8,"Carver County, MN"
2016,Apr,56166,54425,1741,3.1,"Carver County, MN"
2016,May,56204,54606,1598,2.8,"Carver County, MN"
2016,Jun,56372,54434,1938,3.4,"Carver County, MN"
2016,Jul,56955,55156,1799,3.2,"Carver County, MN"
2016,Aug,56703,54849,1854,3.3,"Carver County, MN"
2016,Sep,56504,54721,1783,3.2,"Carver County, MN"
2016,Oct,56382,54648,1734,3.1,"Carver County, MN"
2016,Nov,56246,54634,1612,2.9,"Carver County, MN"
2016,Dec,56236,54312,1924,3.4,"Carver County, MN"
2017,Jan,56842,54691,2151,3.8,"Carver County, MN"
2017,Feb,57177,55048,2129,3.7,"Carver County, MN"
2017,Mar,57382,55386,1996,3.5,"Carver County, MN"
2017,Apr,57515,55847,1668,2.9,"Carver County, MN"
2017,May,57539,55959,1580,2.7,"Carver County, MN"
2017,Jun,58083,56263,1820,3.1,"Carver County, MN"
2017,Jul,58482,56800,1682,2.9,"Carver County, MN"
2017,Aug,58050,56356,1694,2.9,"Carver County, MN"
2017,Sep,58064,56585,1479,2.5,"Carver County, MN"
2017,Oct,57635,56335,1300,2.3,"Carver County, MN"
2017,Nov,57742,56393,1349,2.3,"Carver County, MN"
2017,Dec,57628,56049,1579,2.7,"Carver County, MN"
2018,Jan,57893,56150,1743,3.0,"Carver County, MN"
2018,Feb,58412,56622,1790,3.1,"Carver County, MN"
2018,Mar,58122,56358,1764,3.0,"Carver County, MN"
2018,Apr,57967,56519,1448,2.5,"Carver County, MN"
2018,May,58253,56962,1291,2.2,"Carver County, MN"
2018,Jun,58695,57069,1626,2.8,"Carver County, MN"
2018,Jul,58982,57571,1411,2.4,"Carver County, MN"
2018,Aug,58357,56957,1400,2.4,"Carver County, MN"
2018,Sep,58265,56974,1291,2.2,"Carver County, MN"
2018,Oct,58347,57143,1204,2.1,"Carver County, MN"
2018,Nov,58354,57206,1148,2.0,"Carver County, MN"
2018,Dec,58552,56942,1610,2.7,"Carver County, MN"
2019,Jan,58964,57043,1921,3.3,"Carver County, MN"
2019,Feb,59129,57339,1790,3.0,"Carver County, MN"
2019,Mar,59015,57175,1840,3.1,"Carver County, MN"
2019,Apr,59045,57532,1513,2.6,"Carver County, MN"
2019,May,59345,57812,1533,2.6,"Carver County, MN"
2019,Jun,60020,58129,1891,3.2,"Carver County, MN"
2019,Jul,60391,58595,1796,3.0,"Carver County, MN"
2019,Aug,60053,58344,1709,2.8,"Carver County, MN"
2019,Sep,59871,58366,1505,2.5,"Carver County, MN"
2019,Oct,59943,58446,1497,2.5,"Carver County, MN"
2019,Nov,59772,58393,1379,2.3,"Carver County, MN"
2019,Dec,59937,58287,1650,2.8,"Carver County, MN"
2020,Jan,60444,58652,1792,3.0,"Carver County, MN"
2020,Feb,60717,58934,1783,2.9,"Carver County, MN"
2020,Mar,60401,58026,2375,3.9,"Carver County, MN"
2020,Apr,56919,52779,4140,7.3,"Carver County, MN"
2020,May,57677,52142,5535,9.6,"Carver County, MN"
2020,Jun,60262,55610,4652,7.7,"Carver County, MN"
2020,Jul,60983,56800,4183,6.9,"Carver County, MN"
2020,Aug,60820,57589,3231,5.3,"Carver County, MN"
2020,Sep,60101,57262,2839,4.7,"Carver County, MN"
2020,Oct,60353,57837,2516,4.2,"Carver County, MN"
2020,Nov,59790,57720,2070,3.5,"Carver County, MN"
2020,Dec,58787,56364,2423,4.1,"Carver County, MN"
2021,Jan,57938,55521,2417,4.2,"Carver County, MN"
2021,Feb,57946,55750,2196,3.8,"Carver County, MN"
2021,Mar,57941,55768,2173,3.8,"Carver County, MN"
2021,Apr,58037,56199,1838,3.2,"Carver County, MN"
2021,May,58118,56464,1654,2.8,"Carver County, MN"
2021,Jun,58432,56369,2063,3.5,"Carver County, MN"
2021,Jul,58803,57135,1668,2.8,"Carver County, MN"
2021,Aug,58467,56769,1698,2.9,"Carver County, MN"
2021,Sep,58077,56597,1480,2.5,"Carver County, MN"
2021,Oct,58433,57128,1305,2.2,"Carver County, MN"
2021,Nov,58627,57507,1120,1.9,"Carver County, MN"
2021,Dec,58691,57415,1276,2.2,"Carver County, MN"
2022,Jan,58634,57075,1559,2.7,"Carver County, MN"
2022,Feb,58742,57362,1380,2.3,"Carver County, MN"
2022,Mar,58806,57437,1369,2.3,"Carver County, MN"
2022,Apr,58975,58002,973,1.6,"Carver County, MN"
2022,May,59285,58291,994,1.7,"Carver County, MN"
2022,Jun,59362,58016,1346,2.3,"Carver County, MN"
2022,Jul,59733,58528,1205,2.0,"Carver County, MN"
2022,Aug,59579,58308,1271,2.1,"Carver County, MN"
2022,Sep,59218,58189,1029,1.7,"Carver County, MN"
2022,Oct,58954,57917,1037,1.8,"Carver County, MN"
2022,Nov,58837,57767,1070,1.8,"Carver County, MN"
2022,Dec,59097,57731,1366,2.3,"Carver County, MN"
2023,Jan,59059,57554,1505,2.5,"Carver County, MN"
2023,Feb,59308,57677,1631,2.8,"Carver County, MN"
2023,Mar,59537,57930,1607,2.7,"Carver County, MN"
2023,Apr,59662,58260,1402,2.3,"Carver County, MN"
2023,May,59902,58524,1378,2.3,"Carver County, MN"
2023,Jun,60558,58718,1840,3.0,"Carver County, MN"
2023,Jul,60601,58939,1662,2.7,"Carver County, MN"
2023,Aug,60297,58540,1757,2.9,"Carver County, MN"
2023,Sep,59888,58578,1310,2.2,"Carver County, MN"
2023,Oct,59723,58482,1241,2.1,"Carver County, MN"
2023,Nov,59544,58585,959,1.6,"Carver County, MN"
2023,Dec,59125,57872,1253,2.1,"Carver County, MN"
2024,Jan,59270,57695,1575,2.7,"Carver County, MN"
2024,Feb,59623,57826,1797,3.0,"Carver County, MN"
2024,Mar,59736,58148,1588,2.7,"Carver County, MN"
2024,Apr,59801,58402,1399,2.3,"Carver County, MN"
2024,May,59506,58062,1444,2.4,"Carver County, MN"
2024,Jun,59619,57469,2150,3.6,"Carver County, MN"
2024,Jul,59829,57713,2116,3.5,"Carver County, MN"
2024,Aug,59693,57532,2161,3.6,"Carver County, MN"
2024,Sep,59325,57779,1546,2.6,"Carver County, MN"
2024,Oct,59382,57999,1383,2.3,"Carver County, MN"
2024,Nov,59283(P),57771(P),1512(P),2.6(P),"Carver County, MN"
P : Preliminary.,P : Preliminary.,P : Preliminary.,P : Preliminary.,P : Preliminary.,P : Preliminary.,"Carver County, MN"
2014,Jan,13369,11959,1410,10.5,"Cass County, MN"
2014,Feb,13374,12001,1373,10.3,"Cass County, MN"
2014,Mar,13486,12065,1421,10.5,"Cass County, MN"
2014,Apr,13699,12588,1111,8.1,"Cass County, MN"
2014,May,14254,13370,884,6.2,"Cass County, MN"
2014,Jun,14859,13954,905,6.1,"Cass County, MN"
2014,Jul,14974,14116,858,5.7,"Cass County, MN"
2014,Aug,14814,14022,792,5.3,"Cass County, MN"
2014,Sep,14273,13549,724,5.1,"Cass County, MN"
2014,Oct,13892,13219,673,4.8,"Cass County, MN"
2014,Nov,13704,12742,962,7.0,"Cass County, MN"
2014,Dec,13685,12550,1135,8.3,"Cass County, MN"
2015,Jan,13548,12262,1286,9.5,"Cass County, MN"
2015,Feb,13497,12244,1253,9.3,"Cass County, MN"
2015,Mar,13599,12315,1284,9.4,"Cass County, MN"
2015,Apr,13834,12900,934,6.8,"Cass County, MN"
2015,May,14325,13492,833,5.8,"Cass County, MN"
2015,Jun,14822,13985,837,5.6,"Cass County, MN"
2015,Jul,14907,14087,820,5.5,"Cass County, MN"
2015,Aug,14688,13897,791,5.4,"Cass County, MN"
2015,Sep,14195,13516,679,4.8,"Cass County, MN"
2015,Oct,13919,13240,679,4.9,"Cass County, MN"
2015,Nov,13693,12781,912,6.7,"Cass County, MN"
2015,Dec,13851,12630,1221,8.8,"Cass County, MN"
2016,Jan,13651,12409,1242,9.1,"Cass County, MN"
2016,Feb,13665,12413,1252,9.2,"Cass County, MN"
2016,Mar,13705,12372,1333,9.7,"Cass County, MN"
2016,Apr,13789,12828,961,7.0,"Cass County, MN"
2016,May,14203,13462,741,5.2,"Cass County, MN"
2016,Jun,14940,14095,845,5.7,"Cass County, MN"
2016,Jul,15038,14220,818,5.4,"Cass County, MN"
2016,Aug,14868,14066,802,5.4,"Cass County, MN"
2016,Sep,14523,13791,732,5.0,"Cass County, MN"
2016,Oct,13966,13229,737,5.3,"Cass County, MN"
2016,Nov,13720,12757,963,7.0,"Cass County, MN"
2016,Dec,13725,12550,1175,8.6,"Cass County, MN"
2017,Jan,14065,12675,1390,9.9,"Cass County, MN"
2017,Feb,13983,12686,1297,9.3,"Cass County, MN"
2017,Mar,13933,12716,1217,8.7,"Cass County, MN"
2017,Apr,13914,13061,853,6.1,"Cass County, MN"
2017,May,14345,13693,652,4.5,"Cass County, MN"
2017,Jun,15166,14481,685,4.5,"Cass County, MN"
2017,Jul,15248,14591,657,4.3,"Cass County, MN"
2017,Aug,15100,14441,659,4.4,"Cass County, MN"
2017,Sep,14772,14238,534,3.6,"Cass County, MN"
2017,Oct,14266,13747,519,3.6,"Cass County, MN"
2017,Nov,14145,13250,895,6.3,"Cass County, MN"
2017,Dec,14074,13023,1051,7.5,"Cass County, MN"
2018,Jan,13872,12652,1220,8.8,"Cass County, MN"
2018,Feb,13799,12721,1078,7.8,"Cass County, MN"
2018,Mar,13715,12654,1061,7.7,"Cass County, MN"
2018,Apr,13939,13141,798,5.7,"Cass County, MN"
2018,May,14405,13839,566,3.9,"Cass County, MN"
2018,Jun,15133,14526,607,4.0,"Cass County, MN"
2018,Jul,15256,14693,563,3.7,"Cass County, MN"
2018,Aug,14966,14422,544,3.6,"Cass County, MN"
2018,Sep,14541,14130,411,2.8,"Cass County, MN"
2018,Oct,14105,13666,439,3.1,"Cass County, MN"
2018,Nov,13943,13178,765,5.5,"Cass County, MN"
2018,Dec,14026,12977,1049,7.5,"Cass County, MN"
2019,Jan,14050,12727,1323,9.4,"Cass County, MN"
2019,Feb,13836,12714,1122,8.1,"Cass County, MN"
2019,Mar,13791,12706,1085,7.9,"Cass County, MN"
2019,Apr,13788,12972,816,5.9,"Cass County, MN"
2019,May,14530,13947,583,4.0,"Cass County, MN"
2019,Jun,15329,14675,654,4.3,"Cass County, MN"
2019,Jul,15542,14911,631,4.1,"Cass County, MN"
2019,Aug,15296,14705,591,3.9,"Cass County, MN"
2019,Sep,14798,14324,474,3.2,"Cass County, MN"
2019,Oct,14454,13923,531,3.7,"Cass County, MN"
2019,Nov,14179,13381,798,5.6,"Cass County, MN"
2019,Dec,14246,13159,1087,7.6,"Cass County, MN"
2020,Jan,14233,12988,1245,8.7,"Cass County, MN"
2020,Feb,14186,13036,1150,8.1,"Cass County, MN"
2020,Mar,14168,12805,1363,9.6,"Cass County, MN"
2020,Apr,13142,11229,1913,14.6,"Cass County, MN"
2020,May,14020,11931,2089,14.9,"Cass County, MN"
2020,Jun,15462,13741,1721,11.1,"Cass County, MN"
2020,Jul,15404,13963,1441,9.4,"Cass County, MN"
2020,Aug,15327,14165,1162,7.6,"Cass County, MN"
2020,Sep,14930,13901,1029,6.9,"Cass County, MN"
2020,Oct,14792,13971,821,5.6,"Cass County, MN"
2020,Nov,14219,13311,908,6.4,"Cass County, MN"
2020,Dec,14531,13374,1157,8.0,"Cass County, MN"
2021,Jan,15791,14518,1273,8.1,"Cass County, MN"
2021,Feb,16105,14989,1116,6.9,"Cass County, MN"
2021,Mar,15593,14545,1048,6.7,"Cass County, MN"
2021,Apr,14554,13691,863,5.9,"Cass County, MN"
2021,May,14996,14361,635,4.2,"Cass County, MN"
2021,Jun,17084,16358,726,4.2,"Cass County, MN"
2021,Jul,17717,17116,601,3.4,"Cass County, MN"
2021,Aug,17076,16523,553,3.2,"Cass County, MN"
2021,Sep,16347,15856,491,3.0,"Cass County, MN"
2021,Oct,14944,14491,453,3.0,"Cass County, MN"
2021,Nov,14495,13946,549,3.8,"Cass County, MN"
2021,Dec,14382,13626,756,5.3,"Cass County, MN"
2022,Jan,14249,13311,938,6.6,"Cass County, MN"
2022,Feb,14203,13386,817,5.8,"Cass County, MN"
2022,Mar,14211,13465,746,5.2,"Cass County, MN"
2022,Apr,14328,13765,563,3.9,"Cass County, MN"
2022,May,14863,14433,430,2.9,"Cass County, MN"
2022,Jun,15485,14999,486,3.1,"Cass County, MN"
2022,Jul,15638,15174,464,3.0,"Cass County, MN"
2022,Aug,15580,15090,490,3.1,"Cass County, MN"
2022,Sep,15079,14711,368,2.4,"Cass County, MN"
2022,Oct,14700,14338,362,2.5,"Cass County, MN"
2022,Nov,14303,13741,562,3.9,"Cass County, MN"
2022,Dec,14412,13572,840,5.8,"Cass County, MN"
2023,Jan,14508,13516,992,6.8,"Cass County, MN"
2023,Feb,14569,13537,1032,7.1,"Cass County, MN"
2023,Mar,14461,13524,937,6.5,"Cass County, MN"
2023,Apr,14458,13709,749,5.2,"Cass County, MN"
2023,May,15090,14529,561,3.7,"Cass County, MN"
2023,Jun,15780,15154,626,4.0,"Cass County, MN"
2023,Jul,15729,15192,537,3.4,"Cass County, MN"
2023,Aug,15682,15161,521,3.3,"Cass County, MN"
2023,Sep,15313,14944,369,2.4,"Cass County, MN"
2023,Oct,14878,14525,353,2.4,"Cass County, MN"
2023,Nov,14466,13995,471,3.3,"Cass County, MN"
2023,Dec,14448,13711,737,5.1,"Cass County, MN"
2024,Jan,14504,13530,974,6.7,"Cass County, MN"
2024,Feb,14586,13569,1017,7.0,"Cass County, MN"
2024,Mar,14550,13664,886,6.1,"Cass County, MN"
2024,Apr,14645,13967,678,4.6,"Cass County, MN"
2024,May,15168,14522,646,4.3,"Cass County, MN"
2024,Jun,15697,15010,687,4.4,"Cass County, MN"
2024,Jul,15810,15118,692,4.4,"Cass County, MN"
2024,Aug,15896,15224,672,4.2,"Cass County, MN"
2024,Sep,15439,14943,496,3.2,"Cass County, MN"
2024,Oct,15061,14601,460,3.1,"Cass County, MN"
2024,Nov,14704(P),14023(P),681(P),4.6(P),"Cass County, MN"
P : Preliminary.,P : Preliminary.,P : Preliminary.,P : Preliminary.,P : Preliminary.,P : Preliminary.,"Cass County, MN"
2014,Jan,6818,6312,506,7.4,"Chippewa County, MN"
2014,Feb,6937,6500,437,6.3,"Chippewa County, MN"
2014,Mar,6959,6549,410,5.9,"Chippewa County, MN"
2014,Apr,6868,6524,344,5.0,"Chippewa County, MN"
2014,May,6856,6567,289,4.2,"Chippewa County, MN"
2014,Jun,6907,6596,311,4.5,"Chippewa County, MN"
2014,Jul,6872,6585,287,4.2,"Chippewa County, MN"
2014,Aug,6859,6581,278,4.1,"Chippewa County, MN"
2014,Sep,6880,6651,229,3.3,"Chippewa County, MN"
2014,Oct,7022,6814,208,3.0,"Chippewa County, MN"
2014,Nov,6966,6723,243,3.5,"Chippewa County, MN"
2014,Dec,7013,6707,306,4.4,"Chippewa County, MN"
2015,Jan,7071,6605,466,6.6,"Chippewa County, MN"
2015,Feb,6864,6504,360,5.2,"Chippewa County, MN"
2015,Mar,7118,6687,431,6.1,"Chippewa County, MN"
2015,Apr,6925,6663,262,3.8,"Chippewa County, MN"
2015,May,6912,6612,300,4.3,"Chippewa County, MN"
2015,Jun,7103,6784,319,4.5,"Chippewa County, MN"
2015,Jul,6845,6548,297,4.3,"Chippewa County, MN"
2015,Aug,6776,6510,266,3.9,"Chippewa County, MN"
2015,Sep,6770,6549,221,3.3,"Chippewa County, MN"
2015,Oct,7042,6802,240,3.4,"Chippewa County, MN"
2015,Nov,7020,6780,240,3.4,"Chippewa County, MN"
2015,Dec,7103,6766,337,4.7,"Chippewa County, MN"
2016,Jan,7125,6649,476,6.7,"Chippewa County, MN"
2016,Feb,6980,6538,442,6.3,"Chippewa County, MN"
2016,Mar,7072,6679,393,5.6,"Chippewa County, MN"
2016,Apr,6932,6649,283,4.1,"Chippewa County, MN"
2016,May,6896,6645,251,3.6,"Chippewa County, MN"
2016,Jun,7034,6748,286,4.1,"Chippewa County, MN"
2016,Jul,6817,6489,328,4.8,"Chippewa County, MN"
2016,Aug,6737,6479,258,3.8,"Chippewa County, MN"
2016,Sep,6792,6552,240,3.5,"Chippewa County, MN"
2016,Oct,7011,6780,231,3.3,"Chippewa County, MN"
2016,Nov,7057,6818,239,3.4,"Chippewa County, MN"
2016,Dec,7100,6751,349,4.9,"Chippewa County, MN"
2017,Jan,7173,6765,408,5.7,"Chippewa County, MN"
2017,Feb,7038,6666,372,5.3,"Chippewa County, MN"
2017,Mar,7163,6797,366,5.1,"Chippewa County, MN"
2017,Apr,7036,6729,307,4.4,"Chippewa County, MN"
2017,May,6958,6724,234,3.4,"Chippewa County, MN"
2017,Jun,7076,6810,266,3.8,"Chippewa County, MN"
2017,Jul,6840,6599,241,3.5,"Chippewa County, MN"
2017,Aug,6700,6446,254,3.8,"Chippewa County, MN"
2017,Sep,6766,6559,207,3.1,"Chippewa County, MN"
2017,Oct,6871,6685,186,2.7,"Chippewa County, MN"
2017,Nov,6882,6672,210,3.1,"Chippewa County, MN"
2017,Dec,6983,6688,295,4.2,"Chippewa County, MN"
2018,Jan,6873,6529,344,5.0,"Chippewa County, MN"
2018,Feb,6847,6548,299,4.4,"Chippewa County, MN"
2018,Mar,6908,6590,318,4.6,"Chippewa County, MN"
2018,Apr,6876,6628,248,3.6,"Chippewa County, MN"
2018,May,6921,6732,189,2.7,"Chippewa County, MN"
2018,Jun,6967,6760,207,3.0,"Chippewa County, MN"
2018,Jul,6886,6684,202,2.9,"Chippewa County, MN"
2018,Aug,6667,6498,169,2.5,"Chippewa County, MN"
2018,Sep,6834,6698,136,2.0,"Chippewa County, MN"
2018,Oct,6956,6807,149,2.1,"Chippewa County, MN"
2018,Nov,6909,6745,164,2.4,"Chippewa County, MN"
2018,Dec,7015,6730,285,4.1,"Chippewa County, MN"
2019,Jan,6915,6567,348,5.0,"Chippewa County, MN"
2019,Feb,6894,6553,341,4.9,"Chippewa County, MN"
2019,Mar,6925,6572,353,5.1,"Chippewa County, MN"
2019,Apr,6962,6660,302,4.3,"Chippewa County, MN"
2019,May,6986,6762,224,3.2,"Chippewa County, MN"
2019,Jun,7064,6793,271,3.8,"Chippewa County, MN"
2019,Jul,6868,6582,286,4.2,"Chippewa County, MN"
2019,Aug,6760,6532,228,3.4,"Chippewa County, MN"
2019,Sep,6916,6727,189,2.7,"Chippewa County, MN"
2019,Oct,7009,6802,207,3.0,"Chippewa County, MN"
2019,Nov,6889,6684,205,3.0,"Chippewa County, MN"
2019,Dec,6995,6683,312,4.5,"Chippewa County, MN"
2020,Jan,6855,6485,370,5.4,"Chippewa County, MN"
2020,Feb,6723,6363,360,5.4,"Chippewa County, MN"
2020,Mar,6772,6394,378,5.6,"Chippewa County, MN"
2020,Apr,6599,6073,526,8.0,"Chippewa County, MN"
2020,May,6731,6221,510,7.6,"Chippewa County, MN"
2020,Jun,6959,6560,399,5.7,"Chippewa County, MN"
2020,Jul,6852,6488,364,5.3,"Chippewa County, MN"
2020,Aug,6791,6505,286,4.2,"Chippewa County, MN"
2020,Sep,6843,6598,245,3.6,"Chippewa County, MN"
2020,Oct,6962,6712,250,3.6,"Chippewa County, MN"
2020,Nov,6761,6534,227,3.4,"Chippewa County, MN"
2020,Dec,6703,6405,298,4.4,"Chippewa County, MN"
2021,Jan,6725,6390,335,5.0,"Chippewa County, MN"
2021,Feb,6652,6356,296,4.4,"Chippewa County, MN"
2021,Mar,6627,6331,296,4.5,"Chippewa County, MN"
2021,Apr,6640,6415,225,3.4,"Chippewa County, MN"
2021,May,6696,6488,208,3.1,"Chippewa County, MN"
2021,Jun,6705,6464,241,3.6,"Chippewa County, MN"
2021,Jul,6574,6366,208,3.2,"Chippewa County, MN"
2021,Aug,6519,6339,180,2.8,"Chippewa County, MN"
2021,Sep,6548,6399,149,2.3,"Chippewa County, MN"
2021,Oct,6534,6412,122,1.9,"Chippewa County, MN"
2021,Nov,6482,6371,111,1.7,"Chippewa County, MN"
2021,Dec,6683,6531,152,2.3,"Chippewa County, MN"
2022,Jan,6569,6360,209,3.2,"Chippewa County, MN"
2022,Feb,6536,6349,187,2.9,"Chippewa County, MN"
2022,Mar,6578,6390,188,2.9,"Chippewa County, MN"
2022,Apr,6496,6368,128,2.0,"Chippewa County, MN"
2022,May,6505,6388,117,1.8,"Chippewa County, MN"
2022,Jun,6552,6395,157,2.4,"Chippewa County, MN"
2022,Jul,6402,6263,139,2.2,"Chippewa County, MN"
2022,Aug,6344,6197,147,2.3,"Chippewa County, MN"
2022,Sep,6377,6265,112,1.8,"Chippewa County, MN"
2022,Oct,6363,6262,101,1.6,"Chippewa County, MN"
2022,Nov,6307,6189,118,1.9,"Chippewa County, MN"
2022,Dec,6487,6296,191,2.9,"Chippewa County, MN"
2023,Jan,6385,6123,262,4.1,"Chippewa County, MN"
2023,Feb,6487,6263,224,3.5,"Chippewa County, MN"
2023,Mar,6523,6308,215,3.3,"Chippewa County, MN"
2023,Apr,6463,6297,166,2.6,"Chippewa County, MN"
2023,May,6481,6309,172,2.7,"Chippewa County, MN"
2023,Jun,6538,6318,220,3.4,"Chippewa County, MN"
2023,Jul,6291,6093,198,3.1,"Chippewa County, MN"
2023,Aug,6471,6267,204,3.2,"Chippewa County, MN"
2023,Sep,6505,6376,129,2.0,"Chippewa County, MN"
2023,Oct,6482,6365,117,1.8,"Chippewa County, MN"
2023,Nov,6469,6357,112,1.7,"Chippewa County, MN"
2023,Dec,6444,6284,160,2.5,"Chippewa County, MN"
2024,Jan,6400,6165,235,3.7,"Chippewa County, MN"
2024,Feb,6386,6156,230,3.6,"Chippewa County, MN"
2024,Mar,6515,6319,196,3.0,"Chippewa County, MN"
2024,Apr,6515,6348,167,2.6,"Chippewa County, MN"
2024,May,6396,6226,170,2.7,"Chippewa County, MN"
2024,Jun,6594,6313,281,4.3,"Chippewa County, MN"
2024,Jul,6435,6163,272,4.2,"Chippewa County, MN"
2024,Aug,6588,6349,239,3.6,"Chippewa County, MN"
2024,Sep,6605,6455,150,2.3,"Chippewa County, MN"
2024,Oct,6559,6400,159,2.4,"Chippewa County, MN"
2024,Nov,6528(P),6396(P),132(P),2.0(P),"Chippewa County, MN"
P : Preliminary.,P : Preliminary.,P : Preliminary.,P : Preliminary.,P : Preliminary.,P : Preliminary.,"Chippewa County, MN"
2014,Jan,28576,26699,1877,6.6,"Chisago County, MN"
2014,Feb,28594,26735,1859,6.5,"Chisago County, MN"
2014,Mar,28669,26850,1819,6.3,"Chisago County, MN"
2014,Apr,28609,27128,1481,5.2,"Chisago County, MN"
2014,May,28576,27337,1239,4.3,"Chisago County, MN"
2014,Jun,28753,27448,1305,4.5,"Chisago County, MN"
2014,Jul,28902,27630,1272,4.4,"Chisago County, MN"
2014,Aug,28640,27456,1184,4.1,"Chisago County, MN"
2014,Sep,28493,27404,1089,3.8,"Chisago County, MN"
2014,Oct,28565,27576,989,3.5,"Chisago County, MN"
2014,Nov,28695,27575,1120,3.9,"Chisago County, MN"
2014,Dec,28734,27397,1337,4.7,"Chisago County, MN"
2015,Jan,28676,27074,1602,5.6,"Chisago County, MN"
2015,Feb,28733,27187,1546,5.4,"Chisago County, MN"
2015,Mar,28742,27194,1548,5.4,"Chisago County, MN"
2015,Apr,28732,27563,1169,4.1,"Chisago County, MN"
2015,May,28912,27801,1111,3.8,"Chisago County, MN"
2015,Jun,28956,27739,1217,4.2,"Chisago County, MN"
2015,Jul,29090,27945,1145,3.9,"Chisago County, MN"
2015,Aug,28864,27780,1084,3.8,"Chisago County, MN"
2015,Sep,28558,27579,979,3.4,"Chisago County, MN"
2015,Oct,28605,27673,932,3.3,"Chisago County, MN"
2015,Nov,28767,27739,1028,3.6,"Chisago County, MN"
2015,Dec,29026,27654,1372,4.7,"Chisago County, MN"
2016,Jan,29046,27426,1620,5.6,"Chisago County, MN"
2016,Feb,29228,27632,1596,5.5,"Chisago County, MN"
2016,Mar,29175,27576,1599,5.5,"Chisago County, MN"
2016,Apr,29039,27859,1180,4.1,"Chisago County, MN"
2016,May,28974,27969,1005,3.5,"Chisago County, MN"
2016,Jun,29103,27885,1218,4.2,"Chisago County, MN"
2016,Jul,29392,28259,1133,3.9,"Chisago County, MN"
2016,Aug,29225,28094,1131,3.9,"Chisago County, MN"
2016,Sep,29082,28035,1047,3.6,"Chisago County, MN"
2016,Oct,29002,27950,1052,3.6,"Chisago County, MN"
2016,Nov,29008,27938,1070,3.7,"Chisago County, MN"
2016,Dec,29265,27808,1457,5.0,"Chisago County, MN"
2017,Jan,29493,27760,1733,5.9,"Chisago County, MN"
2017,Feb,29668,27953,1715,5.8,"Chisago County, MN"
2017,Mar,29722,28100,1622,5.5,"Chisago County, MN"
2017,Apr,29503,28328,1175,4.0,"Chisago County, MN"
2017,May,29413,28407,1006,3.4,"Chisago County, MN"
2017,Jun,29693,28582,1111,3.7,"Chisago County, MN"
2017,Jul,29914,28881,1033,3.5,"Chisago County, MN"
2017,Aug,29666,28662,1004,3.4,"Chisago County, MN"
2017,Sep,29648,28777,871,2.9,"Chisago County, MN"
2017,Oct,29385,28603,782,2.7,"Chisago County, MN"
2017,Nov,29579,28639,940,3.2,"Chisago County, MN"
2017,Dec,29718,28480,1238,4.2,"Chisago County, MN"
2018,Jan,29904,28444,1460,4.9,"Chisago County, MN"
2018,Feb,30089,28668,1421,4.7,"Chisago County, MN"
2018,Mar,29954,28508,1446,4.8,"Chisago County, MN"
2018,Apr,29717,28603,1114,3.7,"Chisago County, MN"
2018,May,29640,28827,813,2.7,"Chisago County, MN"
2018,Jun,29864,28900,964,3.2,"Chisago County, MN"
2018,Jul,30046,29182,864,2.9,"Chisago County, MN"
2018,Aug,29711,28879,832,2.8,"Chisago County, MN"
2018,Sep,29585,28868,717,2.4,"Chisago County, MN"
2018,Oct,29667,28924,743,2.5,"Chisago County, MN"
2018,Nov,29755,28964,791,2.7,"Chisago County, MN"
2018,Dec,30041,28844,1197,4.0,"Chisago County, MN"
2019,Jan,30450,28807,1643,5.4,"Chisago County, MN"
2019,Feb,30511,28951,1560,5.1,"Chisago County, MN"
2019,Mar,30432,28856,1576,5.2,"Chisago County, MN"
2019,Apr,30145,29013,1132,3.8,"Chisago County, MN"
2019,May,30078,29163,915,3.0,"Chisago County, MN"
2019,Jun,30423,29339,1084,3.6,"Chisago County, MN"
2019,Jul,30637,29612,1025,3.3,"Chisago County, MN"
2019,Aug,30463,29495,968,3.2,"Chisago County, MN"
2019,Sep,30289,29478,811,2.7,"Chisago County, MN"
2019,Oct,30325,29489,836,2.8,"Chisago County, MN"
2019,Nov,30458,29492,966,3.2,"Chisago County, MN"
2019,Dec,30795,29430,1365,4.4,"Chisago County, MN"
2020,Jan,31034,29339,1695,5.5,"Chisago County, MN"
2020,Feb,31089,29488,1601,5.1,"Chisago County, MN"
2020,Mar,31051,29012,2039,6.6,"Chisago County, MN"
2020,Apr,29124,26343,2781,9.5,"Chisago County, MN"
2020,May,29311,26042,3269,11.2,"Chisago County, MN"
2020,Jun,30503,27817,2686,8.8,"Chisago County, MN"
2020,Jul,30722,28418,2304,7.5,"Chisago County, MN"
2020,Aug,30654,28868,1786,5.8,"Chisago County, MN"
2020,Sep,30288,28668,1620,5.3,"Chisago County, MN"
2020,Oct,30321,28904,1417,4.7,"Chisago County, MN"
2020,Nov,30288,28863,1425,4.7,"Chisago County, MN"
2020,Dec,29952,28170,1782,5.9,"Chisago County, MN"
2021,Jan,29671,27778,1893,6.4,"Chisago County, MN"
2021,Feb,29736,27908,1828,6.1,"Chisago County, MN"
2021,Mar,29509,27886,1623,5.5,"Chisago County, MN"
2021,Apr,29362,28111,1251,4.3,"Chisago County, MN"
2021,May,29279,28252,1027,3.5,"Chisago County, MN"
2021,Jun,29399,28212,1187,4.0,"Chisago County, MN"
2021,Jul,29603,28622,981,3.3,"Chisago County, MN"
2021,Aug,29463,28474,989,3.4,"Chisago County, MN"
2021,Sep,29242,28375,867,3.0,"Chisago County, MN"
2021,Oct,29419,28615,804,2.7,"Chisago County, MN"
2021,Nov,29584,28799,785,2.7,"Chisago County, MN"
2021,Dec,29752,28702,1050,3.5,"Chisago County, MN"
2022,Jan,29841,28527,1314,4.4,"Chisago County, MN"
2022,Feb,29865,28680,1185,4.0,"Chisago County, MN"
2022,Mar,29808,28687,1121,3.8,"Chisago County, MN"
2022,Apr,29784,29002,782,2.6,"Chisago County, MN"
2022,May,29823,29166,657,2.2,"Chisago County, MN"
2022,Jun,29825,29025,800,2.7,"Chisago County, MN"
2022,Jul,29998,29292,706,2.4,"Chisago County, MN"
2022,Aug,29991,29213,778,2.6,"Chisago County, MN"
2022,Sep,29791,29134,657,2.2,"Chisago County, MN"
2022,Oct,29629,28988,641,2.2,"Chisago County, MN"
2022,Nov,29650,28911,739,2.5,"Chisago County, MN"
2022,Dec,30022,28864,1158,3.9,"Chisago County, MN"
2023,Jan,30147,28798,1349,4.5,"Chisago County, MN"
2023,Feb,30291,28853,1438,4.7,"Chisago County, MN"
2023,Mar,30306,28944,1362,4.5,"Chisago County, MN"
2023,Apr,30241,29165,1076,3.6,"Chisago County, MN"
2023,May,30105,29275,830,2.8,"Chisago County, MN"
2023,Jun,30434,29378,1056,3.5,"Chisago County, MN"
2023,Jul,30435,29501,934,3.1,"Chisago County, MN"
2023,Aug,30322,29298,1024,3.4,"Chisago County, MN"
2023,Sep,30003,29307,696,2.3,"Chisago County, MN"
2023,Oct,29916,29248,668,2.2,"Chisago County, MN"
2023,Nov,29918,29295,623,2.1,"Chisago County, MN"
2023,Dec,29937,28980,957,3.2,"Chisago County, MN"
2024,Jan,30175,28872,1303,4.3,"Chisago County, MN"
2024,Feb,30362,28941,1421,4.7,"Chisago County, MN"
2024,Mar,30357,29082,1275,4.2,"Chisago County, MN"
2024,Apr,30208,29228,980,3.2,"Chisago County, MN"
2024,May,30026,29064,962,3.2,"Chisago County, MN"
2024,Jun,29970,28703,1267,4.2,"Chisago County, MN"
2024,Jul,30074,28831,1243,4.1,"Chisago County, MN"
2024,Aug,30055,28750,1305,4.3,"Chisago County, MN"
2024,Sep,29778,28862,916,3.1,"Chisago County, MN"
2024,Oct,29814,28991,823,2.8,"Chisago County, MN"
2024,Nov,29907(P),28882(P),1025(P),3.4(P),"Chisago County, MN"
P : Preliminary.,P : Preliminary.,P : Preliminary.,P : Preliminary.,P : Preliminary.,P : Preliminary.,"Chisago County, MN"
2014,Jan,34730,33051,1679,4.8,"Clay County, MN"
2014,Feb,34957,33285,1672,4.8,"Clay County, MN"
2014,Mar,35096,33530,1566,4.5,"Clay County, MN"
2014,Apr,35113,33867,1246,3.5,"Clay County, MN"
2014,May,35271,34165,1106,3.1,"Clay County, MN"
2014,Jun,35249,33998,1251,3.5,"Clay County, MN"
2014,Jul,35463,34225,1238,3.5,"Clay County, MN"
2014,Aug,35068,33978,1090,3.1,"Clay County, MN"
2014,Sep,35599,34627,972,2.7,"Clay County, MN"
2014,Oct,35794,34877,917,2.6,"Clay County, MN"
2014,Nov,35697,34857,840,2.4,"Clay County, MN"
2014,Dec,35638,34456,1182,3.3,"Clay County, MN"
2015,Jan,35328,33794,1534,4.3,"Clay County, MN"
2015,Feb,35533,34090,1443,4.1,"Clay County, MN"
2015,Mar,35620,34241,1379,3.9,"Clay County, MN"
2015,Apr,35541,34524,1017,2.9,"Clay County, MN"
2015,May,35787,34728,1059,3.0,"Clay County, MN"
2015,Jun,35597,34411,1186,3.3,"Clay County, MN"
2015,Jul,35592,34456,1136,3.2,"Clay County, MN"
2015,Aug,35226,34225,1001,2.8,"Clay County, MN"
2015,Sep,35519,34624,895,2.5,"Clay County, MN"
2015,Oct,35944,35086,858,2.4,"Clay County, MN"
2015,Nov,35847,34989,858,2.4,"Clay County, MN"
2015,Dec,35943,34758,1185,3.3,"Clay County, MN"
2016,Jan,35474,33889,1585,4.5,"Clay County, MN"
2016,Feb,35707,34150,1557,4.4,"Clay County, MN"
2016,Mar,35802,34219,1583,4.4,"Clay County, MN"
2016,Apr,35624,34487,1137,3.2,"Clay County, MN"
2016,May,35616,34620,996,2.8,"Clay County, MN"
2016,Jun,35317,34037,1280,3.6,"Clay County, MN"
2016,Jul,35460,34302,1158,3.3,"Clay County, MN"
2016,Aug,35162,34062,1100,3.1,"Clay County, MN"
2016,Sep,35683,34673,1010,2.8,"Clay County, MN"
2016,Oct,35804,34849,955,2.7,"Clay County, MN"
2016,Nov,35738,34805,933,2.6,"Clay County, MN"
2016,Dec,35705,34328,1377,3.9,"Clay County, MN"
2017,Jan,35636,33983,1653,4.6,"Clay County, MN"
2017,Feb,35863,34257,1606,4.5,"Clay County, MN"
2017,Mar,35854,34367,1487,4.1,"Clay County, MN"
2017,Apr,36038,34895,1143,3.2,"Clay County, MN"
2017,May,35928,34900,1028,2.9,"Clay County, MN"
2017,Jun,35743,34529,1214,3.4,"Clay County, MN"
2017,Jul,35746,34652,1094,3.1,"Clay County, MN"
2017,Aug,35394,34326,1068,3.0,"Clay County, MN"
2017,Sep,35991,35069,922,2.6,"Clay County, MN"
2017,Oct,35935,35176,759,2.1,"Clay County, MN"
2017,Nov,35901,35046,855,2.4,"Clay County, MN"
2017,Dec,35879,34744,1135,3.2,"Clay County, MN"
2018,Jan,35405,33992,1413,4.0,"Clay County, MN"
2018,Feb,35889,34492,1397,3.9,"Clay County, MN"
2018,Mar,35854,34467,1387,3.9,"Clay County, MN"
2018,Apr,35648,34534,1114,3.1,"Clay County, MN"
2018,May,35803,34889,914,2.6,"Clay County, MN"
2018,Jun,35520,34382,1138,3.2,"Clay County, MN"
2018,Jul,35548,34559,989,2.8,"Clay County, MN"
2018,Aug,35033,34120,913,2.6,"Clay County, MN"
2018,Sep,35789,34976,813,2.3,"Clay County, MN"
2018,Oct,35908,35169,739,2.1,"Clay County, MN"
2018,Nov,35813,35080,733,2.0,"Clay County, MN"
2018,Dec,36128,35015,1113,3.1,"Clay County, MN"
2019,Jan,35814,34307,1507,4.2,"Clay County, MN"
2019,Feb,36282,34868,1414,3.9,"Clay County, MN"
2019,Mar,36227,34781,1446,4.0,"Clay County, MN"
2019,Apr,36219,35091,1128,3.1,"Clay County, MN"
2019,May,36457,35432,1025,2.8,"Clay County, MN"
2019,Jun,36235,35029,1206,3.3,"Clay County, MN"
2019,Jul,36147,35021,1126,3.1,"Clay County, MN"
2019,Aug,35780,34799,981,2.7,"Clay County, MN"
2019,Sep,36576,35679,897,2.5,"Clay County, MN"
2019,Oct,36705,35932,773,2.1,"Clay County, MN"
2019,Nov,36456,35649,807,2.2,"Clay County, MN"
2019,Dec,36682,35576,1106,3.0,"Clay County, MN"
2020,Jan,36380,34961,1419,3.9,"Clay County, MN"
2020,Feb,36814,35506,1308,3.6,"Clay County, MN"
2020,Mar,36768,35059,1709,4.6,"Clay County, MN"
2020,Apr,34964,32837,2127,6.1,"Clay County, MN"
2020,May,35437,33111,2326,6.6,"Clay County, MN"
2020,Jun,36618,34377,2241,6.1,"Clay County, MN"
2020,Jul,36941,34992,1949,5.3,"Clay County, MN"
2020,Aug,36801,35417,1384,3.8,"Clay County, MN"
2020,Sep,37284,36043,1241,3.3,"Clay County, MN"
2020,Oct,37453,36286,1167,3.1,"Clay County, MN"
2020,Nov,37006,35890,1116,3.0,"Clay County, MN"
2020,Dec,36760,35545,1215,3.3,"Clay County, MN"
2021,Jan,36843,35336,1507,4.1,"Clay County, MN"
2021,Feb,37036,35551,1485,4.0,"Clay County, MN"
2021,Mar,37078,35655,1423,3.8,"Clay County, MN"
2021,Apr,36872,35686,1186,3.2,"Clay County, MN"
2021,May,36816,35748,1068,2.9,"Clay County, MN"
2021,Jun,36748,35433,1315,3.6,"Clay County, MN"
2021,Jul,36566,35529,1037,2.8,"Clay County, MN"
2021,Aug,36595,35590,1005,2.7,"Clay County, MN"
2021,Sep,37290,36485,805,2.2,"Clay County, MN"
2021,Oct,37151,36477,674,1.8,"Clay County, MN"
2021,Nov,37231,36595,636,1.7,"Clay County, MN"
2021,Dec,37539,36735,804,2.1,"Clay County, MN"
2022,Jan,37163,36100,1063,2.9,"Clay County, MN"
2022,Feb,37314,36357,957,2.6,"Clay County, MN"
2022,Mar,37562,36626,936,2.5,"Clay County, MN"
2022,Apr,37415,36742,673,1.8,"Clay County, MN"
2022,May,37505,36840,665,1.8,"Clay County, MN"
2022,Jun,37375,36527,848,2.3,"Clay County, MN"
2022,Jul,37507,36749,758,2.0,"Clay County, MN"
2022,Aug,37471,36707,764,2.0,"Clay County, MN"
2022,Sep,37949,37376,573,1.5,"Clay County, MN"
2022,Oct,37768,37202,566,1.5,"Clay County, MN"
2022,Nov,37846,37227,619,1.6,"Clay County, MN"
2022,Dec,37836,36998,838,2.2,"Clay County, MN"
2023,Jan,37646,36669,977,2.6,"Clay County, MN"
2023,Feb,38126,37111,1015,2.7,"Clay County, MN"
2023,Mar,38263,37308,955,2.5,"Clay County, MN"
2023,Apr,37965,37142,823,2.2,"Clay County, MN"
2023,May,37971,37206,765,2.0,"Clay County, MN"
2023,Jun,37843,36914,929,2.5,"Clay County, MN"
2023,Jul,37945,37082,863,2.3,"Clay County, MN"
2023,Aug,37997,37153,844,2.2,"Clay County, MN"
2023,Sep,38489,37898,591,1.5,"Clay County, MN"
2023,Oct,38164,37606,558,1.5,"Clay County, MN"
2023,Nov,38137,37677,460,1.2,"Clay County, MN"
2023,Dec,37983,37295,688,1.8,"Clay County, MN"
2024,Jan,38012,37042,970,2.6,"Clay County, MN"
2024,Feb,38273,37136,1137,3.0,"Clay County, MN"
2024,Mar,38490,37526,964,2.5,"Clay County, MN"
2024,Apr,38529,37729,800,2.1,"Clay County, MN"
2024,May,38215,37388,827,2.2,"Clay County, MN"
2024,Jun,38262,37097,1165,3.0,"Clay County, MN"
2024,Jul,38569,37384,1185,3.1,"Clay County, MN"
2024,Aug,38704,37573,1131,2.9,"Clay County, MN"
2024,Sep,39030,38258,772,2.0,"Clay County, MN"
2024,Oct,38787,38076,711,1.8,"Clay County, MN"
2024,Nov,38834(P),38057(P),777(P),2.0(P),"Clay County, MN"
P : Preliminary.,P : Preliminary.,P : Preliminary.,P : Preliminary.,P : Preliminary.,P : Preliminary.,"Clay County, MN"
2014,Jan,4610,3901,709,15.4,"Clearwater County, MN"
2014,Feb,4580,3867,713,15.6,"Clearwater County, MN"
2014,Mar,4712,3957,755,16.0,"Clearwater County, MN"
2014,Apr,4542,3929,613,13.5,"Clearwater County, MN"
2014,May,4425,3986,439,9.9,"Clearwater County, MN"
2014,Jun,4495,4101,394,8.8,"Clearwater County, MN"
2014,Jul,4489,4119,370,8.2,"Clearwater County, MN"
2014,Aug,4454,4121,333,7.5,"Clearwater County, MN"
2014,Sep,4471,4173,298,6.7,"Clearwater County, MN"
2014,Oct,4648,4358,290,6.2,"Clearwater County, MN"
2014,Nov,4655,4235,420,9.0,"Clearwater County, MN"
2014,Dec,4660,4154,506,10.9,"Clearwater County, MN"
2015,Jan,4733,4121,612,12.9,"Clearwater County, MN"
2015,Feb,4677,4089,588,12.6,"Clearwater County, MN"
2015,Mar,4777,4160,617,12.9,"Clearwater County, MN"
2015,Apr,4609,4127,482,10.5,"Clearwater County, MN"
2015,May,4560,4194,366,8.0,"Clearwater County, MN"
2015,Jun,4612,4266,346,7.5,"Clearwater County, MN"
2015,Jul,4476,4154,322,7.2,"Clearwater County, MN"
2015,Aug,4477,4166,311,6.9,"Clearwater County, MN"
2015,Sep,4531,4242,289,6.4,"Clearwater County, MN"
2015,Oct,4650,4346,304,6.5,"Clearwater County, MN"
2015,Nov,4715,4330,385,8.2,"Clearwater County, MN"
2015,Dec,4911,4372,539,11.0,"Clearwater County, MN"
2016,Jan,4957,4322,635,12.8,"Clearwater County, MN"
2016,Feb,4894,4266,628,12.8,"Clearwater County, MN"
2016,Mar,4939,4228,711,14.4,"Clearwater County, MN"
2016,Apr,4788,4240,548,11.4,"Clearwater County, MN"
2016,May,4707,4323,384,8.2,"Clearwater County, MN"
2016,Jun,4695,4320,375,8.0,"Clearwater County, MN"
2016,Jul,4632,4276,356,7.7,"Clearwater County, MN"
2016,Aug,4534,4200,334,7.4,"Clearwater County, MN"
2016,Sep,4544,4256,288,6.3,"Clearwater County, MN"
2016,Oct,4609,4313,296,6.4,"Clearwater County, MN"
2016,Nov,4565,4196,369,8.1,"Clearwater County, MN"
2016,Dec,4692,4183,509,10.8,"Clearwater County, MN"
2017,Jan,4860,4159,701,14.4,"Clearwater County, MN"
2017,Feb,4807,4163,644,13.4,"Clearwater County, MN"
2017,Mar,4785,4171,614,12.8,"Clearwater County, MN"
2017,Apr,4643,4187,456,9.8,"Clearwater County, MN"
2017,May,4551,4237,314,6.9,"Clearwater County, MN"
2017,Jun,4601,4299,302,6.6,"Clearwater County, MN"
2017,Jul,4535,4247,288,6.4,"Clearwater County, MN"
2017,Aug,4457,4185,272,6.1,"Clearwater County, MN"
2017,Sep,4500,4273,227,5.0,"Clearwater County, MN"
2017,Oct,4527,4293,234,5.2,"Clearwater County, MN"
2017,Nov,4607,4219,388,8.4,"Clearwater County, MN"
2017,Dec,4628,4152,476,10.3,"Clearwater County, MN"
2018,Jan,4623,3970,653,14.1,"Clearwater County, MN"
2018,Feb,4594,4016,578,12.6,"Clearwater County, MN"
2018,Mar,4594,3993,601,13.1,"Clearwater County, MN"
2018,Apr,4531,4078,453,10.0,"Clearwater County, MN"
2018,May,4446,4155,291,6.5,"Clearwater County, MN"
2018,Jun,4485,4190,295,6.6,"Clearwater County, MN"
2018,Jul,4409,4151,258,5.9,"Clearwater County, MN"
2018,Aug,4296,4049,247,5.7,"Clearwater County, MN"
2018,Sep,4347,4150,197,4.5,"Clearwater County, MN"
2018,Oct,4366,4164,202,4.6,"Clearwater County, MN"
2018,Nov,4418,4132,286,6.5,"Clearwater County, MN"
2018,Dec,4591,4178,413,9.0,"Clearwater County, MN"
2019,Jan,4659,4019,640,13.7,"Clearwater County, MN"
2019,Feb,4588,4017,571,12.4,"Clearwater County, MN"
2019,Mar,4501,3970,531,11.8,"Clearwater County, MN"
2019,Apr,4430,3985,445,10.0,"Clearwater County, MN"
2019,May,4410,4131,279,6.3,"Clearwater County, MN"
2019,Jun,4458,4164,294,6.6,"Clearwater County, MN"
2019,Jul,4432,4149,283,6.4,"Clearwater County, MN"
2019,Aug,4343,4099,244,5.6,"Clearwater County, MN"
2019,Sep,4434,4247,187,4.2,"Clearwater County, MN"
2019,Oct,4514,4290,224,5.0,"Clearwater County, MN"
2019,Nov,4525,4226,299,6.6,"Clearwater County, MN"
2019,Dec,4616,4128,488,10.6,"Clearwater County, MN"
2020,Jan,4653,3968,685,14.7,"Clearwater County, MN"
2020,Feb,4580,3999,581,12.7,"Clearwater County, MN"
2020,Mar,4630,3971,659,14.2,"Clearwater County, MN"
2020,Apr,4366,3746,620,14.2,"Clearwater County, MN"
2020,May,4459,3911,548,12.3,"Clearwater County, MN"
2020,Jun,4634,4144,490,10.6,"Clearwater County, MN"
2020,Jul,4652,4255,397,8.5,"Clearwater County, MN"
2020,Aug,4602,4332,270,5.9,"Clearwater County, MN"
2020,Sep,4540,4308,232,5.1,"Clearwater County, MN"
2020,Oct,4560,4343,217,4.8,"Clearwater County, MN"
2020,Nov,4482,4166,316,7.1,"Clearwater County, MN"
2020,Dec,4438,4090,348,7.8,"Clearwater County, MN"
2021,Jan,4429,3962,467,10.5,"Clearwater County, MN"
2021,Feb,4468,4052,416,9.3,"Clearwater County, MN"
2021,Mar,4413,4026,387,8.8,"Clearwater County, MN"
2021,Apr,4413,4089,324,7.3,"Clearwater County, MN"
2021,May,4376,4129,247,5.6,"Clearwater County, MN"
2021,Jun,4338,4102,236,5.4,"Clearwater County, MN"
2021,Jul,4366,4175,191,4.4,"Clearwater County, MN"
2021,Aug,4326,4131,195,4.5,"Clearwater County, MN"
2021,Sep,4330,4163,167,3.9,"Clearwater County, MN"
2021,Oct,4417,4241,176,4.0,"Clearwater County, MN"
2021,Nov,4367,4144,223,5.1,"Clearwater County, MN"
2021,Dec,4459,4119,340,7.6,"Clearwater County, MN"
2022,Jan,4541,4055,486,10.7,"Clearwater County, MN"
2022,Feb,4514,4068,446,9.9,"Clearwater County, MN"
2022,Mar,4468,4065,403,9.0,"Clearwater County, MN"
2022,Apr,4468,4117,351,7.9,"Clearwater County, MN"
2022,May,4513,4250,263,5.8,"Clearwater County, MN"
2022,Jun,4438,4221,217,4.9,"Clearwater County, MN"
2022,Jul,4460,4264,196,4.4,"Clearwater County, MN"
2022,Aug,4515,4317,198,4.4,"Clearwater County, MN"
2022,Sep,4449,4307,142,3.2,"Clearwater County, MN"
2022,Oct,4486,4333,153,3.4,"Clearwater County, MN"
2022,Nov,4444,4252,192,4.3,"Clearwater County, MN"
2022,Dec,4545,4193,352,7.7,"Clearwater County, MN"
2023,Jan,4640,4208,432,9.3,"Clearwater County, MN"
2023,Feb,4614,4175,439,9.5,"Clearwater County, MN"
2023,Mar,4498,4067,431,9.6,"Clearwater County, MN"
2023,Apr,4506,4140,366,8.1,"Clearwater County, MN"
2023,May,4494,4257,237,5.3,"Clearwater County, MN"
2023,Jun,4504,4266,238,5.3,"Clearwater County, MN"
2023,Jul,4485,4274,211,4.7,"Clearwater County, MN"
2023,Aug,4585,4369,216,4.7,"Clearwater County, MN"
2023,Sep,4562,4433,129,2.8,"Clearwater County, MN"
2023,Oct,4578,4451,127,2.8,"Clearwater County, MN"
2023,Nov,4564,4395,169,3.7,"Clearwater County, MN"
2023,Dec,4569,4293,276,6.0,"Clearwater County, MN"
2024,Jan,4648,4233,415,8.9,"Clearwater County, MN"
2024,Feb,4633,4228,405,8.7,"Clearwater County, MN"
2024,Mar,4644,4250,394,8.5,"Clearwater County, MN"
2024,Apr,4603,4319,284,6.2,"Clearwater County, MN"
2024,May,4609,4346,263,5.7,"Clearwater County, MN"
2024,Jun,4603,4341,262,5.7,"Clearwater County, MN"
2024,Jul,4606,4352,254,5.5,"Clearwater County, MN"
2024,Aug,4704,4466,238,5.1,"Clearwater County, MN"
2024,Sep,4663,4519,144,3.1,"Clearwater County, MN"
2024,Oct,4649,4523,126,2.7,"Clearwater County, MN"
2024,Nov,4680(P),4454(P),226(P),4.8(P),"Clearwater County, MN"
P : Preliminary.,P : Preliminary.,P : Preliminary.,P : Preliminary.,P : Preliminary.,P : Preliminary.,"Clearwater County, MN"
2014,Jan,2897,2653,244,8.4,"Cook County, MN"
2014,Feb,2854,2618,236,8.3,"Cook County, MN"
2014,Mar,2735,2491,244,8.9,"Cook County, MN"
2014,Apr,2965,2739,226,7.6,"Cook County, MN"
2014,May,2994,2822,172,5.7,"Cook County, MN"
2014,Jun,3240,3081,159,4.9,"Cook County, MN"
2014,Jul,3417,3278,139,4.1,"Cook County, MN"
2014,Aug,3441,3312,129,3.7,"Cook County, MN"
2014,Sep,3338,3220,118,3.5,"Cook County, MN"
2014,Oct,3067,2956,111,3.6,"Cook County, MN"
2014,Nov,2905,2745,160,5.5,"Cook County, MN"
2014,Dec,2919,2737,182,6.2,"Cook County, MN"
2015,Jan,2974,2773,201,6.8,"Cook County, MN"
2015,Feb,2969,2773,196,6.6,"Cook County, MN"
2015,Mar,2987,2796,191,6.4,"Cook County, MN"
2015,Apr,3061,2893,168,5.5,"Cook County, MN"
2015,May,3133,3004,129,4.1,"Cook County, MN"
2015,Jun,3363,3242,121,3.6,"Cook County, MN"
2015,Jul,3488,3377,111,3.2,"Cook County, MN"
2015,Aug,3490,3394,96,2.8,"Cook County, MN"
2015,Sep,3375,3283,92,2.7,"Cook County, MN"
2015,Oct,3123,3029,94,3.0,"Cook County, MN"
2015,Nov,2961,2828,133,4.5,"Cook County, MN"
2015,Dec,3015,2847,168,5.6,"Cook County, MN"
2016,Jan,2909,2729,180,6.2,"Cook County, MN"
2016,Feb,2899,2725,174,6.0,"Cook County, MN"
2016,Mar,2863,2689,174,6.1,"Cook County, MN"
2016,Apr,2964,2793,171,5.8,"Cook County, MN"
2016,May,3059,2934,125,4.1,"Cook County, MN"
2016,Jun,3311,3191,120,3.6,"Cook County, MN"
2016,Jul,3419,3306,113,3.3,"Cook County, MN"
2016,Aug,3424,3313,111,3.2,"Cook County, MN"
2016,Sep,3296,3195,101,3.1,"Cook County, MN"
2016,Oct,3050,2955,95,3.1,"Cook County, MN"
2016,Nov,2942,2796,146,5.0,"Cook County, MN"
2016,Dec,2972,2796,176,5.9,"Cook County, MN"
2017,Jan,2983,2793,190,6.4,"Cook County, MN"
2017,Feb,2950,2770,180,6.1,"Cook County, MN"
2017,Mar,2944,2776,168,5.7,"Cook County, MN"
2017,Apr,2926,2777,149,5.1,"Cook County, MN"
2017,May,3032,2929,103,3.4,"Cook County, MN"
2017,Jun,3326,3235,91,2.7,"Cook County, MN"
2017,Jul,3467,3388,79,2.3,"Cook County, MN"
2017,Aug,3454,3378,76,2.2,"Cook County, MN"
2017,Sep,3337,3270,67,2.0,"Cook County, MN"
2017,Oct,3100,3035,65,2.1,"Cook County, MN"
2017,Nov,2974,2848,126,4.2,"Cook County, MN"
2017,Dec,2975,2816,159,5.3,"Cook County, MN"
2018,Jan,2851,2686,165,5.8,"Cook County, MN"
2018,Feb,2858,2695,163,5.7,"Cook County, MN"
2018,Mar,2833,2677,156,5.5,"Cook County, MN"
2018,Apr,2840,2710,130,4.6,"Cook County, MN"
2018,May,2986,2899,87,2.9,"Cook County, MN"
2018,Jun,3187,3107,80,2.5,"Cook County, MN"
2018,Jul,3421,3352,69,2.0,"Cook County, MN"
2018,Aug,3319,3258,61,1.8,"Cook County, MN"
2018,Sep,3266,3215,51,1.6,"Cook County, MN"
2018,Oct,3098,3040,58,1.9,"Cook County, MN"
2018,Nov,2953,2846,107,3.6,"Cook County, MN"
2018,Dec,2969,2803,166,5.6,"Cook County, MN"
2019,Jan,2937,2716,221,7.5,"Cook County, MN"
2019,Feb,2891,2710,181,6.3,"Cook County, MN"
2019,Mar,2894,2720,174,6.0,"Cook County, MN"
2019,Apr,2954,2800,154,5.2,"Cook County, MN"
2019,May,3124,3020,104,3.3,"Cook County, MN"
2019,Jun,3280,3166,114,3.5,"Cook County, MN"
2019,Jul,3478,3370,108,3.1,"Cook County, MN"
2019,Aug,3435,3341,94,2.7,"Cook County, MN"
2019,Sep,3354,3277,77,2.3,"Cook County, MN"
2019,Oct,3191,3101,90,2.8,"Cook County, MN"
2019,Nov,3041,2913,128,4.2,"Cook County, MN"
2019,Dec,3053,2861,192,6.3,"Cook County, MN"
2020,Jan,2916,2726,190,6.5,"Cook County, MN"
2020,Feb,2930,2757,173,5.9,"Cook County, MN"
2020,Mar,2883,2674,209,7.2,"Cook County, MN"
2020,Apr,2716,2236,480,17.7,"Cook County, MN"
2020,May,2885,2386,499,17.3,"Cook County, MN"
2020,Jun,3104,2749,355,11.4,"Cook County, MN"
2020,Jul,3263,3009,254,7.8,"Cook County, MN"
2020,Aug,3282,3109,173,5.3,"Cook County, MN"
2020,Sep,3205,3046,159,5.0,"Cook County, MN"
2020,Oct,3072,2939,133,4.3,"Cook County, MN"
2020,Nov,2954,2782,172,5.8,"Cook County, MN"
2020,Dec,2876,2644,232,8.1,"Cook County, MN"
2021,Jan,2791,2557,234,8.4,"Cook County, MN"
2021,Feb,2779,2581,198,7.1,"Cook County, MN"
2021,Mar,2741,2555,186,6.8,"Cook County, MN"
2021,Apr,2862,2687,175,6.1,"Cook County, MN"
2021,May,2944,2799,145,4.9,"Cook County, MN"
2021,Jun,3076,2929,147,4.8,"Cook County, MN"
2021,Jul,3225,3107,118,3.7,"Cook County, MN"
2021,Aug,3228,3119,109,3.4,"Cook County, MN"
2021,Sep,3172,3078,94,3.0,"Cook County, MN"
2021,Oct,3005,2930,75,2.5,"Cook County, MN"
2021,Nov,2869,2787,82,2.9,"Cook County, MN"
2021,Dec,2873,2744,129,4.5,"Cook County, MN"
2022,Jan,2788,2643,145,5.2,"Cook County, MN"
2022,Feb,2780,2652,128,4.6,"Cook County, MN"
2022,Mar,2744,2622,122,4.4,"Cook County, MN"
2022,Apr,2641,2542,99,3.7,"Cook County, MN"
2022,May,2780,2701,79,2.8,"Cook County, MN"
2022,Jun,2993,2915,78,2.6,"Cook County, MN"
2022,Jul,3069,3003,66,2.2,"Cook County, MN"
2022,Aug,3120,3046,74,2.4,"Cook County, MN"
2022,Sep,3003,2940,63,2.1,"Cook County, MN"
2022,Oct,2930,2864,66,2.3,"Cook County, MN"
2022,Nov,2800,2699,101,3.6,"Cook County, MN"
2022,Dec,2797,2664,133,4.8,"Cook County, MN"
2023,Jan,2816,2688,128,4.5,"Cook County, MN"
2023,Feb,2829,2680,149,5.3,"Cook County, MN"
2023,Mar,2786,2639,147,5.3,"Cook County, MN"
2023,Apr,2773,2638,135,4.9,"Cook County, MN"
2023,May,2798,2697,101,3.6,"Cook County, MN"
2023,Jun,3080,2979,101,3.3,"Cook County, MN"
2023,Jul,3115,3039,76,2.4,"Cook County, MN"
2023,Aug,3177,3092,85,2.7,"Cook County, MN"
2023,Sep,2986,2923,63,2.1,"Cook County, MN"
2023,Oct,2888,2828,60,2.1,"Cook County, MN"
2023,Nov,2787,2699,88,3.2,"Cook County, MN"
2023,Dec,2779,2650,129,4.6,"Cook County, MN"
2024,Jan,2750,2601,149,5.4,"Cook County, MN"
2024,Feb,2756,2596,160,5.8,"Cook County, MN"
2024,Mar,2776,2622,154,5.5,"Cook County, MN"
2024,Apr,2748,2598,150,5.5,"Cook County, MN"
2024,May,2780,2654,126,4.5,"Cook County, MN"
2024,Jun,2967,2855,112,3.8,"Cook County, MN"
2024,Jul,3070,2957,113,3.7,"Cook County, MN"
2024,Aug,3154,3052,102,3.2,"Cook County, MN"
2024,Sep,3008,2934,74,2.5,"Cook County, MN"
2024,Oct,2948,2876,72,2.4,"Cook County, MN"
2024,Nov,2835(P),2714(P),121(P),4.3(P),"Cook County, MN"
P : Preliminary.,P : Preliminary.,P : Preliminary.,P : Preliminary.,P : Preliminary.,P : Preliminary.,"Cook County, MN"
2014,Jan,5575,5271,304,5.5,"Cottonwood County, MN"
2014,Feb,5567,5267,300,5.4,"Cottonwood County, MN"
2014,Mar,5611,5314,297,5.3,"Cottonwood County, MN"
2014,Apr,5555,5318,237,4.3,"Cottonwood County, MN"
2014,May,5513,5284,229,4.2,"Cottonwood County, MN"
2014,Jun,5477,5010,467,8.5,"Cottonwood County, MN"
2014,Jul,5681,5382,299,5.3,"Cottonwood County, MN"
2014,Aug,5626,5395,231,4.1,"Cottonwood County, MN"
2014,Sep,5565,5311,254,4.6,"Cottonwood County, MN"
2014,Oct,5574,5032,542,9.7,"Cottonwood County, MN"
2014,Nov,5654,5447,207,3.7,"Cottonwood County, MN"
2014,Dec,5749,5504,245,4.3,"Cottonwood County, MN"
2015,Jan,5746,5478,268,4.7,"Cottonwood County, MN"
2015,Feb,5674,5421,253,4.5,"Cottonwood County, MN"
2015,Mar,5918,5651,267,4.5,"Cottonwood County, MN"
2015,Apr,5805,5599,206,3.5,"Cottonwood County, MN"
2015,May,5794,5568,226,3.9,"Cottonwood County, MN"
2015,Jun,5937,5630,307,5.2,"Cottonwood County, MN"
2015,Jul,5740,5485,255,4.4,"Cottonwood County, MN"
2015,Aug,5604,5334,270,4.8,"Cottonwood County, MN"
2015,Sep,5756,5444,312,5.4,"Cottonwood County, MN"
2015,Oct,5975,5609,366,6.1,"Cottonwood County, MN"
2015,Nov,5800,5536,264,4.6,"Cottonwood County, MN"
2015,Dec,5896,5497,399,6.8,"Cottonwood County, MN"
2016,Jan,5698,5359,339,5.9,"Cottonwood County, MN"
2016,Feb,5533,5199,334,6.0,"Cottonwood County, MN"
2016,Mar,5648,5311,337,6.0,"Cottonwood County, MN"
2016,Apr,5568,5317,251,4.5,"Cottonwood County, MN"
2016,May,5550,5253,297,5.4,"Cottonwood County, MN"
2016,Jun,5673,5236,437,7.7,"Cottonwood County, MN"
2016,Jul,5365,4696,669,12.5,"Cottonwood County, MN"
2016,Aug,5353,4911,442,8.3,"Cottonwood County, MN"
2016,Sep,5329,4874,455,8.5,"Cottonwood County, MN"
2016,Oct,5505,4906,599,10.9,"Cottonwood County, MN"
2016,Nov,5581,5286,295,5.3,"Cottonwood County, MN"
2016,Dec,5546,5255,291,5.2,"Cottonwood County, MN"
2017,Jan,5635,5321,314,5.6,"Cottonwood County, MN"
2017,Feb,5520,5247,273,4.9,"Cottonwood County, MN"
2017,Mar,5634,5367,267,4.7,"Cottonwood County, MN"
2017,Apr,5632,5395,237,4.2,"Cottonwood County, MN"
2017,May,5803,5590,213,3.7,"Cottonwood County, MN"
2017,Jun,5899,5647,252,4.3,"Cottonwood County, MN"
2017,Jul,5736,5457,279,4.9,"Cottonwood County, MN"
2017,Aug,5603,4968,635,11.3,"Cottonwood County, MN"
2017,Sep,5668,5134,534,9.4,"Cottonwood County, MN"
2017,Oct,5890,5670,220,3.7,"Cottonwood County, MN"
2017,Nov,5937,5745,192,3.2,"Cottonwood County, MN"
2017,Dec,5962,5755,207,3.5,"Cottonwood County, MN"
2018,Jan,5688,5451,237,4.2,"Cottonwood County, MN"
2018,Feb,5741,5506,235,4.1,"Cottonwood County, MN"
2018,Mar,5830,5607,223,3.8,"Cottonwood County, MN"
2018,Apr,5869,5682,187,3.2,"Cottonwood County, MN"
2018,May,5903,5753,150,2.5,"Cottonwood County, MN"
2018,Jun,5963,5750,213,3.6,"Cottonwood County, MN"
2018,Jul,5833,5534,299,5.1,"Cottonwood County, MN"
2018,Aug,5610,5267,343,6.1,"Cottonwood County, MN"
2018,Sep,5716,5550,166,2.9,"Cottonwood County, MN"
2018,Oct,5846,5685,161,2.8,"Cottonwood County, MN"
2018,Nov,5867,5715,152,2.6,"Cottonwood County, MN"
2018,Dec,5876,5680,196,3.3,"Cottonwood County, MN"
2019,Jan,5744,5481,263,4.6,"Cottonwood County, MN"
2019,Feb,5732,5491,241,4.2,"Cottonwood County, MN"
2019,Mar,5834,5586,248,4.3,"Cottonwood County, MN"
2019,Apr,5883,5689,194,3.3,"Cottonwood County, MN"
2019,May,6001,5821,180,3.0,"Cottonwood County, MN"
2019,Jun,6135,5875,260,4.2,"Cottonwood County, MN"
2019,Jul,6144,5810,334,5.4,"Cottonwood County, MN"
2019,Aug,5796,5570,226,3.9,"Cottonwood County, MN"
2019,Sep,5903,5708,195,3.3,"Cottonwood County, MN"
2019,Oct,6073,5893,180,3.0,"Cottonwood County, MN"
2019,Nov,6047,5894,153,2.5,"Cottonwood County, MN"
2019,Dec,6099,5897,202,3.3,"Cottonwood County, MN"
2020,Jan,5978,5718,260,4.3,"Cottonwood County, MN"
2020,Feb,5987,5749,238,4.0,"Cottonwood County, MN"
2020,Mar,6061,5766,295,4.9,"Cottonwood County, MN"
2020,Apr,6355,6040,315,5.0,"Cottonwood County, MN"
2020,May,6178,5751,427,6.9,"Cottonwood County, MN"
2020,Jun,6453,6061,392,6.1,"Cottonwood County, MN"
2020,Jul,6093,5718,375,6.2,"Cottonwood County, MN"
2020,Aug,6391,6139,252,3.9,"Cottonwood County, MN"
2020,Sep,6519,6272,247,3.8,"Cottonwood County, MN"
2020,Oct,6877,6551,326,4.7,"Cottonwood County, MN"
2020,Nov,6751,6501,250,3.7,"Cottonwood County, MN"
2020,Dec,6804,6517,287,4.2,"Cottonwood County, MN"
2021,Jan,6559,6266,293,4.5,"Cottonwood County, MN"
2021,Feb,6494,6227,267,4.1,"Cottonwood County, MN"
2021,Mar,6536,6266,270,4.1,"Cottonwood County, MN"
2021,Apr,6495,6266,229,3.5,"Cottonwood County, MN"
2021,May,6607,6365,242,3.7,"Cottonwood County, MN"
2021,Jun,6672,6374,298,4.5,"Cottonwood County, MN"
2021,Jul,6574,6128,446,6.8,"Cottonwood County, MN"
2021,Aug,6390,6189,201,3.1,"Cottonwood County, MN"
2021,Sep,6453,6288,165,2.6,"Cottonwood County, MN"
2021,Oct,6574,6407,167,2.5,"Cottonwood County, MN"
2021,Nov,6637,6507,130,2.0,"Cottonwood County, MN"
2021,Dec,6740,6583,157,2.3,"Cottonwood County, MN"
2022,Jan,6575,6369,206,3.1,"Cottonwood County, MN"
2022,Feb,6579,6415,164,2.5,"Cottonwood County, MN"
2022,Mar,6657,6498,159,2.4,"Cottonwood County, MN"
2022,Apr,6527,6406,121,1.9,"Cottonwood County, MN"
2022,May,6593,6451,142,2.2,"Cottonwood County, MN"
2022,Jun,6725,6535,190,2.8,"Cottonwood County, MN"
2022,Jul,6649,6256,393,5.9,"Cottonwood County, MN"
2022,Aug,6577,6389,188,2.9,"Cottonwood County, MN"
2022,Sep,6611,6473,138,2.1,"Cottonwood County, MN"
2022,Oct,6719,6585,134,2.0,"Cottonwood County, MN"
2022,Nov,6722,6596,126,1.9,"Cottonwood County, MN"
2022,Dec,6829,6648,181,2.7,"Cottonwood County, MN"
2023,Jan,6664,6467,197,3.0,"Cottonwood County, MN"
2023,Feb,6656,6450,206,3.1,"Cottonwood County, MN"
2023,Mar,6750,6557,193,2.9,"Cottonwood County, MN"
2023,Apr,6607,6443,164,2.5,"Cottonwood County, MN"
2023,May,6629,6459,170,2.6,"Cottonwood County, MN"
2023,Jun,6816,6355,461,6.8,"Cottonwood County, MN"
2023,Jul,5833,5279,554,9.5,"Cottonwood County, MN"
2023,Aug,5918,5510,408,6.9,"Cottonwood County, MN"
2023,Sep,6104,5620,484,7.9,"Cottonwood County, MN"
2023,Oct,5995,5729,266,4.4,"Cottonwood County, MN"
2023,Nov,6021,5832,189,3.1,"Cottonwood County, MN"
2023,Dec,5897,5674,223,3.8,"Cottonwood County, MN"
2024,Jan,5778,5538,240,4.2,"Cottonwood County, MN"
2024,Feb,5755,5511,244,4.2,"Cottonwood County, MN"
2024,Mar,5909,5709,200,3.4,"Cottonwood County, MN"
2024,Apr,5830,5682,148,2.5,"Cottonwood County, MN"
2024,May,5702,5555,147,2.6,"Cottonwood County, MN"
2024,Jun,5950,5675,275,4.6,"Cottonwood County, MN"
2024,Jul,6158,5711,447,7.3,"Cottonwood County, MN"
2024,Aug,6323,6010,313,5.0,"Cottonwood County, MN"
2024,Sep,6380,6151,229,3.6,"Cottonwood County, MN"
2024,Oct,6338,6155,183,2.9,"Cottonwood County, MN"
2024,Nov,6468(P),6272(P),196(P),3.0(P),"Cottonwood County, MN"
P : Preliminary.,P : Preliminary.,P : Preliminary.,P : Preliminary.,P : Preliminary.,P : Preliminary.,"Cottonwood County, MN"
2014,Jan,30937,28291,2646,8.6,"Crow Wing County, MN"
2014,Feb,30825,28253,2572,8.3,"Crow Wing County, MN"
2014,Mar,31119,28474,2645,8.5,"Crow Wing County, MN"
2014,Apr,31250,29208,2042,6.5,"Crow Wing County, MN"
2014,May,31909,30278,1631,5.1,"Crow Wing County, MN"
2014,Jun,32775,31092,1683,5.1,"Crow Wing County, MN"
2014,Jul,32343,30771,1572,4.9,"Crow Wing County, MN"
2014,Aug,32165,30691,1474,4.6,"Crow Wing County, MN"
2014,Sep,31699,30327,1372,4.3,"Crow Wing County, MN"
2014,Oct,31431,30107,1324,4.2,"Crow Wing County, MN"
2014,Nov,31272,29501,1771,5.7,"Crow Wing County, MN"
2014,Dec,30978,28987,1991,6.4,"Crow Wing County, MN"
2015,Jan,30896,28625,2271,7.4,"Crow Wing County, MN"
2015,Feb,30742,28525,2217,7.2,"Crow Wing County, MN"
2015,Mar,30643,28462,2181,7.1,"Crow Wing County, MN"
2015,Apr,31453,29831,1622,5.2,"Crow Wing County, MN"
2015,May,32169,30746,1423,4.4,"Crow Wing County, MN"
2015,Jun,32732,31240,1492,4.6,"Crow Wing County, MN"
2015,Jul,32500,31104,1396,4.3,"Crow Wing County, MN"
2015,Aug,32425,31112,1313,4.0,"Crow Wing County, MN"
2015,Sep,31809,30601,1208,3.8,"Crow Wing County, MN"
2015,Oct,31243,29999,1244,4.0,"Crow Wing County, MN"
2015,Nov,31151,29571,1580,5.1,"Crow Wing County, MN"
2015,Dec,31221,29222,1999,6.4,"Crow Wing County, MN"
2016,Jan,30967,28782,2185,7.1,"Crow Wing County, MN"
2016,Feb,31120,28987,2133,6.9,"Crow Wing County, MN"
2016,Mar,31208,28978,2230,7.1,"Crow Wing County, MN"
2016,Apr,31580,30005,1575,5.0,"Crow Wing County, MN"
2016,May,32100,30832,1268,4.0,"Crow Wing County, MN"
2016,Jun,33115,31685,1430,4.3,"Crow Wing County, MN"
2016,Jul,33071,31737,1334,4.0,"Crow Wing County, MN"
2016,Aug,32967,31637,1330,4.0,"Crow Wing County, MN"
2016,Sep,32089,30832,1257,3.9,"Crow Wing County, MN"
2016,Oct,31413,30196,1217,3.9,"Crow Wing County, MN"
2016,Nov,31054,29552,1502,4.8,"Crow Wing County, MN"
2016,Dec,31154,29152,2002,6.4,"Crow Wing County, MN"
2017,Jan,31575,29305,2270,7.2,"Crow Wing County, MN"
2017,Feb,31686,29571,2115,6.7,"Crow Wing County, MN"
2017,Mar,31678,29680,1998,6.3,"Crow Wing County, MN"
2017,Apr,31778,30370,1408,4.4,"Crow Wing County, MN"
2017,May,32394,31275,1119,3.5,"Crow Wing County, MN"
2017,Jun,33812,32600,1212,3.6,"Crow Wing County, MN"
2017,Jul,33401,32276,1125,3.4,"Crow Wing County, MN"
2017,Aug,33157,32049,1108,3.3,"Crow Wing County, MN"
2017,Sep,32791,31795,996,3.0,"Crow Wing County, MN"
2017,Oct,32159,31254,905,2.8,"Crow Wing County, MN"
2017,Nov,31986,30537,1449,4.5,"Crow Wing County, MN"
2017,Dec,31963,30142,1821,5.7,"Crow Wing County, MN"
2018,Jan,31561,29580,1981,6.3,"Crow Wing County, MN"
2018,Feb,31657,29805,1852,5.9,"Crow Wing County, MN"
2018,Mar,31521,29721,1800,5.7,"Crow Wing County, MN"
2018,Apr,31685,30344,1341,4.2,"Crow Wing County, MN"
2018,May,32409,31450,959,3.0,"Crow Wing County, MN"
2018,Jun,33542,32443,1099,3.3,"Crow Wing County, MN"
2018,Jul,33314,32349,965,2.9,"Crow Wing County, MN"
2018,Aug,32785,31855,930,2.8,"Crow Wing County, MN"
2018,Sep,32437,31587,850,2.6,"Crow Wing County, MN"
2018,Oct,32013,31129,884,2.8,"Crow Wing County, MN"
2018,Nov,31677,30416,1261,4.0,"Crow Wing County, MN"
2018,Dec,31913,30129,1784,5.6,"Crow Wing County, MN"
2019,Jan,31950,29801,2149,6.7,"Crow Wing County, MN"
2019,Feb,31692,29764,1928,6.1,"Crow Wing County, MN"
2019,Mar,31622,29740,1882,6.0,"Crow Wing County, MN"
2019,Apr,31554,30214,1340,4.2,"Crow Wing County, MN"
2019,May,32609,31517,1092,3.3,"Crow Wing County, MN"
2019,Jun,33755,32532,1223,3.6,"Crow Wing County, MN"
2019,Jul,33626,32496,1130,3.4,"Crow Wing County, MN"
2019,Aug,33166,32078,1088,3.3,"Crow Wing County, MN"
2019,Sep,32673,31702,971,3.0,"Crow Wing County, MN"
2019,Oct,32179,31186,993,3.1,"Crow Wing County, MN"
2019,Nov,32169,30794,1375,4.3,"Crow Wing County, MN"
2019,Dec,32181,30302,1879,5.8,"Crow Wing County, MN"
2020,Jan,32334,30216,2118,6.6,"Crow Wing County, MN"
2020,Feb,32203,30301,1902,5.9,"Crow Wing County, MN"
2020,Mar,32053,29731,2322,7.2,"Crow Wing County, MN"
2020,Apr,30449,26951,3498,11.5,"Crow Wing County, MN"
2020,May,31693,27753,3940,12.4,"Crow Wing County, MN"
2020,Jun,33798,30861,2937,8.7,"Crow Wing County, MN"
2020,Jul,33706,31212,2494,7.4,"Crow Wing County, MN"
2020,Aug,33706,31774,1932,5.7,"Crow Wing County, MN"
2020,Sep,33433,31694,1739,5.2,"Crow Wing County, MN"
2020,Oct,32920,31404,1516,4.6,"Crow Wing County, MN"
2020,Nov,32165,30409,1756,5.5,"Crow Wing County, MN"
2020,Dec,31708,29261,2447,7.7,"Crow Wing County, MN"
2021,Jan,32092,29718,2374,7.4,"Crow Wing County, MN"
2021,Feb,32293,30202,2091,6.5,"Crow Wing County, MN"
2021,Mar,32039,30143,1896,5.9,"Crow Wing County, MN"
2021,Apr,32499,30969,1530,4.7,"Crow Wing County, MN"
2021,May,33243,32031,1212,3.6,"Crow Wing County, MN"
2021,Jun,33923,32559,1364,4.0,"Crow Wing County, MN"
2021,Jul,33569,32464,1105,3.3,"Crow Wing County, MN"
2021,Aug,33549,32458,1091,3.3,"Crow Wing County, MN"
2021,Sep,33565,32575,990,2.9,"Crow Wing County, MN"
2021,Oct,32936,32049,887,2.7,"Crow Wing County, MN"
2021,Nov,32441,31455,986,3.0,"Crow Wing County, MN"
2021,Dec,32355,31066,1289,4.0,"Crow Wing County, MN"
2022,Jan,32575,31001,1574,4.8,"Crow Wing County, MN"
2022,Feb,32538,31138,1400,4.3,"Crow Wing County, MN"
2022,Mar,32683,31358,1325,4.1,"Crow Wing County, MN"
2022,Apr,32966,32064,902,2.7,"Crow Wing County, MN"
2022,May,33875,33101,774,2.3,"Crow Wing County, MN"
2022,Jun,34584,33688,896,2.6,"Crow Wing County, MN"
2022,Jul,34558,33772,786,2.3,"Crow Wing County, MN"
2022,Aug,34249,33436,813,2.4,"Crow Wing County, MN"
2022,Sep,34016,33313,703,2.1,"Crow Wing County, MN"
2022,Oct,33489,32742,747,2.2,"Crow Wing County, MN"
2022,Nov,33025,32012,1013,3.1,"Crow Wing County, MN"
2022,Dec,33112,31661,1451,4.4,"Crow Wing County, MN"
2023,Jan,33277,31683,1594,4.8,"Crow Wing County, MN"
2023,Feb,33464,31807,1657,5.0,"Crow Wing County, MN"
2023,Mar,33298,31800,1498,4.5,"Crow Wing County, MN"
2023,Apr,33590,32344,1246,3.7,"Crow Wing County, MN"
2023,May,34124,33108,1016,3.0,"Crow Wing County, MN"
2023,Jun,35055,33912,1143,3.3,"Crow Wing County, MN"
2023,Jul,34881,33827,1054,3.0,"Crow Wing County, MN"
2023,Aug,34583,33520,1063,3.1,"Crow Wing County, MN"
2023,Sep,34366,33589,777,2.3,"Crow Wing County, MN"
2023,Oct,33787,33028,759,2.2,"Crow Wing County, MN"
2023,Nov,33266,32374,892,2.7,"Crow Wing County, MN"
2023,Dec,33297,32028,1269,3.8,"Crow Wing County, MN"
2024,Jan,33464,31890,1574,4.7,"Crow Wing County, MN"
2024,Feb,33671,31935,1736,5.2,"Crow Wing County, MN"
2024,Mar,33545,32092,1453,4.3,"Crow Wing County, MN"
2024,Apr,33886,32770,1116,3.3,"Crow Wing County, MN"
2024,May,34574,33416,1158,3.3,"Crow Wing County, MN"
2024,Jun,35039,33736,1303,3.7,"Crow Wing County, MN"
2024,Jul,34987,33628,1359,3.9,"Crow Wing County, MN"
2024,Aug,34836,33521,1315,3.8,"Crow Wing County, MN"
2024,Sep,34554,33558,996,2.9,"Crow Wing County, MN"
2024,Oct,34198,33242,956,2.8,"Crow Wing County, MN"
2024,Nov,33770(P),32509(P),1261(P),3.7(P),"Crow Wing County, MN"
P : Preliminary.,P : Preliminary.,P : Preliminary.,P : Preliminary.,P : Preliminary.,P : Preliminary.,"Crow Wing County, MN"
2014,Jan,229375,218478,10897,4.8,"Dakota County, MN"
2014,Feb,229869,218982,10887,4.7,"Dakota County, MN"
2014,Mar,230506,219845,10661,4.6,"Dakota County, MN"
2014,Apr,231013,222242,8771,3.8,"Dakota County, MN"
2014,May,232544,224004,8540,3.7,"Dakota County, MN"
2014,Jun,234357,224799,9558,4.1,"Dakota County, MN"
2014,Jul,235061,225752,9309,4.0,"Dakota County, MN"
2014,Aug,232946,224180,8766,3.8,"Dakota County, MN"
2014,Sep,231957,223988,7969,3.4,"Dakota County, MN"
2014,Oct,232402,225142,7260,3.1,"Dakota County, MN"
2014,Nov,232476,225277,7199,3.1,"Dakota County, MN"
2014,Dec,231645,223786,7859,3.4,"Dakota County, MN"
2015,Jan,229820,220537,9283,4.0,"Dakota County, MN"
2015,Feb,231000,222079,8921,3.9,"Dakota County, MN"
2015,Mar,230280,221568,8712,3.8,"Dakota County, MN"
2015,Apr,232319,225070,7249,3.1,"Dakota County, MN"
2015,May,234944,227341,7603,3.2,"Dakota County, MN"
2015,Jun,234649,226218,8431,3.6,"Dakota County, MN"
2015,Jul,236350,228159,8191,3.5,"Dakota County, MN"
2015,Aug,234323,226717,7606,3.2,"Dakota County, MN"
2015,Sep,232321,225261,7060,3.0,"Dakota County, MN"
2015,Oct,232003,225165,6838,2.9,"Dakota County, MN"
2015,Nov,232765,226105,6660,2.9,"Dakota County, MN"
2015,Dec,232938,225250,7688,3.3,"Dakota County, MN"
2016,Jan,231599,222863,8736,3.8,"Dakota County, MN"
2016,Feb,233944,225140,8804,3.8,"Dakota County, MN"
2016,Mar,233553,224633,8920,3.8,"Dakota County, MN"
2016,Apr,234483,227101,7382,3.1,"Dakota County, MN"
2016,May,234932,227981,6951,3.0,"Dakota County, MN"
2016,Jun,235580,227045,8535,3.6,"Dakota County, MN"
2016,Jul,238260,230186,8074,3.4,"Dakota County, MN"
2016,Aug,237104,229019,8085,3.4,"Dakota County, MN"
2016,Sep,236398,228742,7656,3.2,"Dakota County, MN"
2016,Oct,234872,227403,7469,3.2,"Dakota County, MN"
2016,Nov,234343,227420,6923,3.0,"Dakota County, MN"
2016,Dec,234223,226200,8023,3.4,"Dakota County, MN"
2017,Jan,234810,225851,8959,3.8,"Dakota County, MN"
2017,Feb,236847,228009,8838,3.7,"Dakota County, MN"
2017,Mar,237647,229452,8195,3.4,"Dakota County, MN"
2017,Apr,238271,231194,7077,3.0,"Dakota County, MN"
2017,May,238572,231703,6869,2.9,"Dakota County, MN"
2017,Jun,241166,233118,8048,3.3,"Dakota County, MN"
2017,Jul,242856,235310,7546,3.1,"Dakota County, MN"
2017,Aug,241409,233889,7520,3.1,"Dakota County, MN"
2017,Sep,241510,234980,6530,2.7,"Dakota County, MN"
2017,Oct,238515,232760,5755,2.4,"Dakota County, MN"
2017,Nov,239221,233392,5829,2.4,"Dakota County, MN"
2017,Dec,238679,231962,6717,2.8,"Dakota County, MN"
2018,Jan,238931,231496,7435,3.1,"Dakota County, MN"
2018,Feb,240930,233526,7404,3.1,"Dakota County, MN"
2018,Mar,239849,232525,7324,3.1,"Dakota County, MN"
2018,Apr,238953,232952,6001,2.5,"Dakota County, MN"
2018,May,239715,234253,5462,2.3,"Dakota County, MN"
2018,Jun,241959,235004,6955,2.9,"Dakota County, MN"
2018,Jul,242829,236552,6277,2.6,"Dakota County, MN"
2018,Aug,241253,235074,6179,2.6,"Dakota County, MN"
2018,Sep,240288,234848,5440,2.3,"Dakota County, MN"
2018,Oct,240364,235092,5272,2.2,"Dakota County, MN"
2018,Nov,241065,235896,5169,2.1,"Dakota County, MN"
2018,Dec,241442,234662,6780,2.8,"Dakota County, MN"
2019,Jan,242367,234130,8237,3.4,"Dakota County, MN"
2019,Feb,243218,235528,7690,3.2,"Dakota County, MN"
2019,Mar,242807,234813,7994,3.3,"Dakota County, MN"
2019,Apr,242102,235655,6447,2.7,"Dakota County, MN"
2019,May,242780,236172,6608,2.7,"Dakota County, MN"
2019,Jun,245779,237728,8051,3.3,"Dakota County, MN"
2019,Jul,246568,238941,7627,3.1,"Dakota County, MN"
2019,Aug,246166,238818,7348,3.0,"Dakota County, MN"
2019,Sep,245169,238897,6272,2.6,"Dakota County, MN"
2019,Oct,244819,238497,6322,2.6,"Dakota County, MN"
2019,Nov,245138,239055,6083,2.5,"Dakota County, MN"
2019,Dec,245712,238745,6967,2.8,"Dakota County, MN"
2020,Jan,246768,239154,7614,3.1,"Dakota County, MN"
2020,Feb,247824,240228,7596,3.1,"Dakota County, MN"
2020,Mar,247005,236813,10192,4.1,"Dakota County, MN"
2020,Apr,235463,214102,21361,9.1,"Dakota County, MN"
2020,May,239815,211256,28559,11.9,"Dakota County, MN"
2020,Jun,248877,225109,23768,9.6,"Dakota County, MN"
2020,Jul,250377,229307,21070,8.4,"Dakota County, MN"
2020,Aug,249661,233160,16501,6.6,"Dakota County, MN"
2020,Sep,247048,232240,14808,6.0,"Dakota County, MN"
2020,Oct,245362,233569,11793,4.8,"Dakota County, MN"
2020,Nov,243467,233888,9579,3.9,"Dakota County, MN"
2020,Dec,239559,228424,11135,4.6,"Dakota County, MN"
2021,Jan,236836,225687,11149,4.7,"Dakota County, MN"
2021,Feb,237022,226811,10211,4.3,"Dakota County, MN"
2021,Mar,237515,227542,9973,4.2,"Dakota County, MN"
2021,Apr,238073,229151,8922,3.7,"Dakota County, MN"
2021,May,238278,229893,8385,3.5,"Dakota County, MN"
2021,Jun,239098,229301,9797,4.1,"Dakota County, MN"
2021,Jul,239787,231657,8130,3.4,"Dakota County, MN"
2021,Aug,238241,230312,7929,3.3,"Dakota County, MN"
2021,Sep,237202,230126,7076,3.0,"Dakota County, MN"
2021,Oct,237760,231673,6087,2.6,"Dakota County, MN"
2021,Nov,239143,233935,5208,2.2,"Dakota County, MN"
2021,Dec,239068,233239,5829,2.4,"Dakota County, MN"
2022,Jan,239302,232344,6958,2.9,"Dakota County, MN"
2022,Feb,239610,233514,6096,2.5,"Dakota County, MN"
2022,Mar,240432,234353,6079,2.5,"Dakota County, MN"
2022,Apr,241264,236856,4408,1.8,"Dakota County, MN"
2022,May,242446,237848,4598,1.9,"Dakota County, MN"
2022,Jun,242847,236776,6071,2.5,"Dakota County, MN"
2022,Jul,243457,237897,5560,2.3,"Dakota County, MN"
2022,Aug,243221,237320,5901,2.4,"Dakota County, MN"
2022,Sep,242055,237201,4854,2.0,"Dakota County, MN"
2022,Oct,240096,235331,4765,2.0,"Dakota County, MN"
2022,Nov,240049,235304,4745,2.0,"Dakota County, MN"
2022,Dec,240881,234853,6028,2.5,"Dakota County, MN"
2023,Jan,240919,234293,6626,2.8,"Dakota County, MN"
2023,Feb,241847,234879,6968,2.9,"Dakota County, MN"
2023,Mar,243125,236343,6782,2.8,"Dakota County, MN"
2023,Apr,243505,237695,5810,2.4,"Dakota County, MN"
2023,May,244878,238827,6051,2.5,"Dakota County, MN"
2023,Jun,247685,239948,7737,3.1,"Dakota County, MN"
2023,Jul,247316,240332,6984,2.8,"Dakota County, MN"
2023,Aug,245210,237789,7421,3.0,"Dakota County, MN"
2023,Sep,243613,238108,5505,2.3,"Dakota County, MN"
2023,Oct,242499,237243,5256,2.2,"Dakota County, MN"
2023,Nov,241947,237850,4097,1.7,"Dakota County, MN"
2023,Dec,240731,235393,5338,2.2,"Dakota County, MN"
2024,Jan,241690,234969,6721,2.8,"Dakota County, MN"
2024,Feb,243261,235678,7583,3.1,"Dakota County, MN"
2024,Mar,243223,236572,6651,2.7,"Dakota County, MN"
2024,Apr,243308,237428,5880,2.4,"Dakota County, MN"
2024,May,242479,236620,5859,2.4,"Dakota County, MN"
2024,Jun,242566,233778,8788,3.6,"Dakota County, MN"
2024,Jul,243060,234146,8914,3.7,"Dakota County, MN"
2024,Aug,241354,232296,9058,3.8,"Dakota County, MN"
2024,Sep,240425,233635,6790,2.8,"Dakota County, MN"
2024,Oct,240767,234671,6096,2.5,"Dakota County, MN"
2024,Nov,240302(P),233758(P),6544(P),2.7(P),"Dakota County, MN"
P : Preliminary.,P : Preliminary.,P : Preliminary.,P : Preliminary.,P : Preliminary.,P : Preliminary.,"Dakota County, MN"
2014,Jan,11255,10575,680,6.0,"Dodge County, MN"
2014,Feb,11213,10525,688,6.1,"Dodge County, MN"
2014,Mar,11274,10600,674,6.0,"Dodge County, MN"
2014,Apr,11158,10649,509,4.6,"Dodge County, MN"
2014,May,11119,10716,403,3.6,"Dodge County, MN"
2014,Jun,11343,10879,464,4.1,"Dodge County, MN"
2014,Jul,11525,11074,451,3.9,"Dodge County, MN"
2014,Aug,11478,11063,415,3.6,"Dodge County, MN"
2014,Sep,11187,10834,353,3.2,"Dodge County, MN"
2014,Oct,11299,10964,335,3.0,"Dodge County, MN"
2014,Nov,11203,10857,346,3.1,"Dodge County, MN"
2014,Dec,11242,10797,445,4.0,"Dodge County, MN"
2015,Jan,11380,10790,590,5.2,"Dodge County, MN"
2015,Feb,11274,10699,575,5.1,"Dodge County, MN"
2015,Mar,11427,10847,580,5.1,"Dodge County, MN"
2015,Apr,11315,10905,410,3.6,"Dodge County, MN"
2015,May,11316,10952,364,3.2,"Dodge County, MN"
2015,Jun,11596,11172,424,3.7,"Dodge County, MN"
2015,Jul,11677,11256,421,3.6,"Dodge County, MN"
2015,Aug,11602,11219,383,3.3,"Dodge County, MN"
2015,Sep,11414,11061,353,3.1,"Dodge County, MN"
2015,Oct,11635,11275,360,3.1,"Dodge County, MN"
2015,Nov,11576,11232,344,3.0,"Dodge County, MN"
2015,Dec,11554,11113,441,3.8,"Dodge County, MN"
2016,Jan,11679,11102,577,4.9,"Dodge County, MN"
2016,Feb,11557,10973,584,5.1,"Dodge County, MN"
2016,Mar,11703,11104,599,5.1,"Dodge County, MN"
2016,Apr,11430,11068,362,3.2,"Dodge County, MN"
2016,May,11403,11086,317,2.8,"Dodge County, MN"
2016,Jun,11584,11163,421,3.6,"Dodge County, MN"
2016,Jul,11679,11276,403,3.5,"Dodge County, MN"
2016,Aug,11627,11209,418,3.6,"Dodge County, MN"
2016,Sep,11380,11026,354,3.1,"Dodge County, MN"
2016,Oct,11543,11212,331,2.9,"Dodge County, MN"
2016,Nov,11510,11177,333,2.9,"Dodge County, MN"
2016,Dec,11495,11047,448,3.9,"Dodge County, MN"
2017,Jan,11732,11132,600,5.1,"Dodge County, MN"
2017,Feb,11681,11102,579,5.0,"Dodge County, MN"
2017,Mar,11731,11201,530,4.5,"Dodge County, MN"
2017,Apr,11715,11329,386,3.3,"Dodge County, MN"
2017,May,11693,11357,336,2.9,"Dodge County, MN"
2017,Jun,11917,11509,408,3.4,"Dodge County, MN"
2017,Jul,11985,11597,388,3.2,"Dodge County, MN"
2017,Aug,11836,11457,379,3.2,"Dodge County, MN"
2017,Sep,11643,11345,298,2.6,"Dodge County, MN"
2017,Oct,11725,11464,261,2.2,"Dodge County, MN"
2017,Nov,11649,11396,253,2.2,"Dodge County, MN"
2017,Dec,11723,11342,381,3.3,"Dodge County, MN"
2018,Jan,11671,11163,508,4.4,"Dodge County, MN"
2018,Feb,11758,11238,520,4.4,"Dodge County, MN"
2018,Mar,11806,11312,494,4.2,"Dodge County, MN"
2018,Apr,11726,11348,378,3.2,"Dodge County, MN"
2018,May,11764,11494,270,2.3,"Dodge County, MN"
2018,Jun,11902,11546,356,3.0,"Dodge County, MN"
2018,Jul,12033,11720,313,2.6,"Dodge County, MN"
2018,Aug,11805,11485,320,2.7,"Dodge County, MN"
2018,Sep,11716,11437,279,2.4,"Dodge County, MN"
2018,Oct,11776,11505,271,2.3,"Dodge County, MN"
2018,Nov,11685,11413,272,2.3,"Dodge County, MN"
2018,Dec,11769,11374,395,3.4,"Dodge County, MN"
2019,Jan,11849,11287,562,4.7,"Dodge County, MN"
2019,Feb,11789,11258,531,4.5,"Dodge County, MN"
2019,Mar,11870,11304,566,4.8,"Dodge County, MN"
2019,Apr,11824,11415,409,3.5,"Dodge County, MN"
2019,May,11869,11549,320,2.7,"Dodge County, MN"
2019,Jun,12020,11604,416,3.5,"Dodge County, MN"
2019,Jul,12219,11830,389,3.2,"Dodge County, MN"
2019,Aug,12033,11672,361,3.0,"Dodge County, MN"
2019,Sep,11896,11608,288,2.4,"Dodge County, MN"
2019,Oct,12040,11741,299,2.5,"Dodge County, MN"
2019,Nov,11906,11592,314,2.6,"Dodge County, MN"
2019,Dec,12081,11628,453,3.7,"Dodge County, MN"
2020,Jan,11991,11433,558,4.7,"Dodge County, MN"
2020,Feb,11987,11457,530,4.4,"Dodge County, MN"
2020,Mar,12008,11356,652,5.4,"Dodge County, MN"
2020,Apr,11661,10920,741,6.4,"Dodge County, MN"
2020,May,11929,10782,1147,9.6,"Dodge County, MN"
2020,Jun,12107,11177,930,7.7,"Dodge County, MN"
2020,Jul,12498,11728,770,6.2,"Dodge County, MN"
2020,Aug,12339,11814,525,4.3,"Dodge County, MN"
2020,Sep,12143,11686,457,3.8,"Dodge County, MN"
2020,Oct,12557,11920,637,5.1,"Dodge County, MN"
2020,Nov,12154,11698,456,3.8,"Dodge County, MN"
2020,Dec,12029,11500,529,4.4,"Dodge County, MN"
2021,Jan,11964,11322,642,5.4,"Dodge County, MN"
2021,Feb,11972,11321,651,5.4,"Dodge County, MN"
2021,Mar,11889,11293,596,5.0,"Dodge County, MN"
2021,Apr,11791,11411,380,3.2,"Dodge County, MN"
2021,May,11811,11486,325,2.8,"Dodge County, MN"
2021,Jun,11941,11536,405,3.4,"Dodge County, MN"
2021,Jul,12112,11771,341,2.8,"Dodge County, MN"
2021,Aug,12010,11664,346,2.9,"Dodge County, MN"
2021,Sep,11805,11520,285,2.4,"Dodge County, MN"
2021,Oct,11827,11576,251,2.1,"Dodge County, MN"
2021,Nov,11759,11526,233,2.0,"Dodge County, MN"
2021,Dec,11958,11614,344,2.9,"Dodge County, MN"
2022,Jan,11983,11493,490,4.1,"Dodge County, MN"
2022,Feb,11928,11489,439,3.7,"Dodge County, MN"
2022,Mar,11930,11518,412,3.5,"Dodge County, MN"
2022,Apr,11769,11492,277,2.4,"Dodge County, MN"
2022,May,11761,11550,211,1.8,"Dodge County, MN"
2022,Jun,11893,11601,292,2.5,"Dodge County, MN"
2022,Jul,12112,11844,268,2.2,"Dodge County, MN"
2022,Aug,12014,11741,273,2.3,"Dodge County, MN"
2022,Sep,11806,11615,191,1.6,"Dodge County, MN"
2022,Oct,11822,11634,188,1.6,"Dodge County, MN"
2022,Nov,11747,11523,224,1.9,"Dodge County, MN"
2022,Dec,11924,11572,352,3.0,"Dodge County, MN"
2023,Jan,11948,11488,460,3.9,"Dodge County, MN"
2023,Feb,12016,11529,487,4.1,"Dodge County, MN"
2023,Mar,12074,11610,464,3.8,"Dodge County, MN"
2023,Apr,11947,11587,360,3.0,"Dodge County, MN"
2023,May,11905,11623,282,2.4,"Dodge County, MN"
2023,Jun,12084,11707,377,3.1,"Dodge County, MN"
2023,Jul,12198,11851,347,2.8,"Dodge County, MN"
2023,Aug,12227,11872,355,2.9,"Dodge County, MN"
2023,Sep,11989,11757,232,1.9,"Dodge County, MN"
2023,Oct,12079,11853,226,1.9,"Dodge County, MN"
2023,Nov,12060,11871,189,1.6,"Dodge County, MN"
2023,Dec,12085,11770,315,2.6,"Dodge County, MN"
2024,Jan,12243,11791,452,3.7,"Dodge County, MN"
2024,Feb,12291,11773,518,4.2,"Dodge County, MN"
2024,Mar,12368,11928,440,3.6,"Dodge County, MN"
2024,Apr,12297,11980,317,2.6,"Dodge County, MN"
2024,May,12218,11867,351,2.9,"Dodge County, MN"
2024,Jun,12449,12019,430,3.5,"Dodge County, MN"
2024,Jul,12732,12283,449,3.5,"Dodge County, MN"
2024,Aug,12923,12472,451,3.5,"Dodge County, MN"
2024,Sep,12770,12488,282,2.2,"Dodge County, MN"
2024,Oct,12754,12505,249,2.0,"Dodge County, MN"
2024,Nov,12821(P),12514(P),307(P),2.4(P),"Dodge County, MN"
P : Preliminary.,P : Preliminary.,P : Preliminary.,P : Preliminary.,P : Preliminary.,P : Preliminary.,"Dodge County, MN"
2014,Jan,19403,18395,1008,5.2,"Douglas County, MN"
2014,Feb,19359,18362,997,5.2,"Douglas County, MN"
2014,Mar,19495,18537,958,4.9,"Douglas County, MN"
2014,Apr,19618,18845,773,3.9,"Douglas County, MN"
2014,May,20119,19446,673,3.3,"Douglas County, MN"
2014,Jun,20437,19722,715,3.5,"Douglas County, MN"
2014,Jul,20622,19931,691,3.4,"Douglas County, MN"
2014,Aug,20547,19900,647,3.1,"Douglas County, MN"
2014,Sep,20037,19446,591,2.9,"Douglas County, MN"
2014,Oct,19957,19393,564,2.8,"Douglas County, MN"
2014,Nov,19870,19184,686,3.5,"Douglas County, MN"
2014,Dec,19543,18723,820,4.2,"Douglas County, MN"
2015,Jan,19863,18922,941,4.7,"Douglas County, MN"
2015,Feb,19715,18800,915,4.6,"Douglas County, MN"
2015,Mar,19781,18858,923,4.7,"Douglas County, MN"
2015,Apr,19921,19254,667,3.3,"Douglas County, MN"
2015,May,20331,19687,644,3.2,"Douglas County, MN"
2015,Jun,20731,20046,685,3.3,"Douglas County, MN"
2015,Jul,20722,20090,632,3.0,"Douglas County, MN"
2015,Aug,20597,20007,590,2.9,"Douglas County, MN"
2015,Sep,20129,19601,528,2.6,"Douglas County, MN"
2015,Oct,20087,19571,516,2.6,"Douglas County, MN"
2015,Nov,20006,19409,597,3.0,"Douglas County, MN"
2015,Dec,20311,19496,815,4.0,"Douglas County, MN"
2016,Jan,20055,19121,934,4.7,"Douglas County, MN"
2016,Feb,20049,19126,923,4.6,"Douglas County, MN"
2016,Mar,20111,19215,896,4.5,"Douglas County, MN"
2016,Apr,20054,19413,641,3.2,"Douglas County, MN"
2016,May,20251,19702,549,2.7,"Douglas County, MN"
2016,Jun,20687,20039,648,3.1,"Douglas County, MN"
2016,Jul,20765,20147,618,3.0,"Douglas County, MN"
2016,Aug,20682,20069,613,3.0,"Douglas County, MN"
2016,Sep,20118,19531,587,2.9,"Douglas County, MN"
2016,Oct,19990,19424,566,2.8,"Douglas County, MN"
2016,Nov,19857,19233,624,3.1,"Douglas County, MN"
2016,Dec,19997,19141,856,4.3,"Douglas County, MN"
2017,Jan,20348,19359,989,4.9,"Douglas County, MN"
2017,Feb,20360,19436,924,4.5,"Douglas County, MN"
2017,Mar,20444,19561,883,4.3,"Douglas County, MN"
2017,Apr,20472,19796,676,3.3,"Douglas County, MN"
2017,May,20719,20169,550,2.7,"Douglas County, MN"
2017,Jun,21215,20613,602,2.8,"Douglas County, MN"
2017,Jul,21335,20792,543,2.5,"Douglas County, MN"
2017,Aug,21065,20533,532,2.5,"Douglas County, MN"
2017,Sep,20589,20120,469,2.3,"Douglas County, MN"
2017,Oct,20355,19918,437,2.1,"Douglas County, MN"
2017,Nov,20279,19693,586,2.9,"Douglas County, MN"
2017,Dec,20290,19540,750,3.7,"Douglas County, MN"
2018,Jan,20103,19285,818,4.1,"Douglas County, MN"
2018,Feb,20187,19409,778,3.9,"Douglas County, MN"
2018,Mar,20221,19436,785,3.9,"Douglas County, MN"
2018,Apr,20487,19861,626,3.1,"Douglas County, MN"
2018,May,20757,20303,454,2.2,"Douglas County, MN"
2018,Jun,21299,20748,551,2.6,"Douglas County, MN"
2018,Jul,21432,20937,495,2.3,"Douglas County, MN"
2018,Aug,21074,20595,479,2.3,"Douglas County, MN"
2018,Sep,20503,20077,426,2.1,"Douglas County, MN"
2018,Oct,20423,19984,439,2.1,"Douglas County, MN"
2018,Nov,20405,19868,537,2.6,"Douglas County, MN"
2018,Dec,20642,19830,812,3.9,"Douglas County, MN"
2019,Jan,20725,19783,942,4.5,"Douglas County, MN"
2019,Feb,20730,19854,876,4.2,"Douglas County, MN"
2019,Mar,20712,19841,871,4.2,"Douglas County, MN"
2019,Apr,20830,20129,701,3.4,"Douglas County, MN"
2019,May,21308,20756,552,2.6,"Douglas County, MN"
2019,Jun,21852,21192,660,3.0,"Douglas County, MN"
2019,Jul,21951,21332,619,2.8,"Douglas County, MN"
2019,Aug,21637,21058,579,2.7,"Douglas County, MN"
2019,Sep,21109,20617,492,2.3,"Douglas County, MN"
2019,Oct,21057,20584,473,2.2,"Douglas County, MN"
2019,Nov,20936,20389,547,2.6,"Douglas County, MN"
2019,Dec,20995,20182,813,3.9,"Douglas County, MN"
2020,Jan,21039,20140,899,4.3,"Douglas County, MN"
2020,Feb,21213,20358,855,4.0,"Douglas County, MN"
2020,Mar,21049,19992,1057,5.0,"Douglas County, MN"
2020,Apr,20070,18513,1557,7.8,"Douglas County, MN"
2020,May,20455,18822,1633,8.0,"Douglas County, MN"
2020,Jun,22080,20792,1288,5.8,"Douglas County, MN"
2020,Jul,22469,21395,1074,4.8,"Douglas County, MN"
2020,Aug,22341,21495,846,3.8,"Douglas County, MN"
2020,Sep,21754,21012,742,3.4,"Douglas County, MN"
2020,Oct,21713,21064,649,3.0,"Douglas County, MN"
2020,Nov,21508,20752,756,3.5,"Douglas County, MN"
2020,Dec,21046,19998,1048,5.0,"Douglas County, MN"
2021,Jan,21122,20109,1013,4.8,"Douglas County, MN"
2021,Feb,21206,20287,919,4.3,"Douglas County, MN"
2021,Mar,21062,20204,858,4.1,"Douglas County, MN"
2021,Apr,21266,20596,670,3.2,"Douglas County, MN"
2021,May,21573,21006,567,2.6,"Douglas County, MN"
2021,Jun,21815,21127,688,3.2,"Douglas County, MN"
2021,Jul,21989,21448,541,2.5,"Douglas County, MN"
2021,Aug,22046,21486,560,2.5,"Douglas County, MN"
2021,Sep,21490,21004,486,2.3,"Douglas County, MN"
2021,Oct,21526,21111,415,1.9,"Douglas County, MN"
2021,Nov,21560,21125,435,2.0,"Douglas County, MN"
2021,Dec,21439,20871,568,2.6,"Douglas County, MN"
2022,Jan,21208,20506,702,3.3,"Douglas County, MN"
2022,Feb,21275,20671,604,2.8,"Douglas County, MN"
2022,Mar,21100,20496,604,2.9,"Douglas County, MN"
2022,Apr,21200,20790,410,1.9,"Douglas County, MN"
2022,May,21725,21360,365,1.7,"Douglas County, MN"
2022,Jun,21922,21454,468,2.1,"Douglas County, MN"
2022,Jul,22061,21643,418,1.9,"Douglas County, MN"
2022,Aug,22076,21641,435,2.0,"Douglas County, MN"
2022,Sep,21486,21143,343,1.6,"Douglas County, MN"
2022,Oct,21564,21208,356,1.7,"Douglas County, MN"
2022,Nov,21382,20947,435,2.0,"Douglas County, MN"
2022,Dec,21464,20828,636,3.0,"Douglas County, MN"
2023,Jan,21337,20639,698,3.3,"Douglas County, MN"
2023,Feb,21425,20683,742,3.5,"Douglas County, MN"
2023,Mar,21293,20592,701,3.3,"Douglas County, MN"
2023,Apr,21613,21038,575,2.7,"Douglas County, MN"
2023,May,21782,21266,516,2.4,"Douglas County, MN"
2023,Jun,22223,21579,644,2.9,"Douglas County, MN"
2023,Jul,22217,21658,559,2.5,"Douglas County, MN"
2023,Aug,22173,21545,628,2.8,"Douglas County, MN"
2023,Sep,21686,21224,462,2.1,"Douglas County, MN"
2023,Oct,21585,21175,410,1.9,"Douglas County, MN"
2023,Nov,21457,21072,385,1.8,"Douglas County, MN"
2023,Dec,21365,20809,556,2.6,"Douglas County, MN"
2024,Jan,21398,20665,733,3.4,"Douglas County, MN"
2024,Feb,21462,20681,781,3.6,"Douglas County, MN"
2024,Mar,21414,20750,664,3.1,"Douglas County, MN"
2024,Apr,21655,21106,549,2.5,"Douglas County, MN"
2024,May,21746,21198,548,2.5,"Douglas County, MN"
2024,Jun,21920,21252,668,3.0,"Douglas County, MN"
2024,Jul,22132,21446,686,3.1,"Douglas County, MN"
2024,Aug,22190,21541,649,2.9,"Douglas County, MN"
2024,Sep,21679,21212,467,2.2,"Douglas County, MN"
2024,Oct,21594,21161,433,2.0,"Douglas County, MN"
2024,Nov,21542(P),20993(P),549(P),2.5(P),"Douglas County, MN"
P : Preliminary.,P : Preliminary.,P : Preliminary.,P : Preliminary.,P : Preliminary.,P : Preliminary.,"Douglas County, MN"
2014,Jan,7302,6764,538,7.4,"Faribault County, MN"
2014,Feb,7276,6678,598,8.2,"Faribault County, MN"
2014,Mar,7324,6796,528,7.2,"Faribault County, MN"
2014,Apr,7224,6803,421,5.8,"Faribault County, MN"
2014,May,7183,6824,359,5.0,"Faribault County, MN"
2014,Jun,7495,7123,372,5.0,"Faribault County, MN"
2014,Jul,7497,7136,361,4.8,"Faribault County, MN"
2014,Aug,7608,7283,325,4.3,"Faribault County, MN"
2014,Sep,7492,7210,282,3.8,"Faribault County, MN"
2014,Oct,7479,7197,282,3.8,"Faribault County, MN"
2014,Nov,7374,7063,311,4.2,"Faribault County, MN"
2014,Dec,7457,7096,361,4.8,"Faribault County, MN"
2015,Jan,7491,7062,429,5.7,"Faribault County, MN"
2015,Feb,7298,6891,407,5.6,"Faribault County, MN"
2015,Mar,7503,7090,413,5.5,"Faribault County, MN"
2015,Apr,7385,7073,312,4.2,"Faribault County, MN"
2015,May,7390,7091,299,4.0,"Faribault County, MN"
2015,Jun,7770,7392,378,4.9,"Faribault County, MN"
2015,Jul,7550,7214,336,4.5,"Faribault County, MN"
2015,Aug,7580,7290,290,3.8,"Faribault County, MN"
2015,Sep,7515,7251,264,3.5,"Faribault County, MN"
2015,Oct,7754,7487,267,3.4,"Faribault County, MN"
2015,Nov,7494,7209,285,3.8,"Faribault County, MN"
2015,Dec,7524,7174,350,4.7,"Faribault County, MN"
2016,Jan,7463,7080,383,5.1,"Faribault County, MN"
2016,Feb,7258,6859,399,5.5,"Faribault County, MN"
2016,Mar,7398,7008,390,5.3,"Faribault County, MN"
2016,Apr,7210,6890,320,4.4,"Faribault County, MN"
2016,May,7210,6939,271,3.8,"Faribault County, MN"
2016,Jun,7477,7163,314,4.2,"Faribault County, MN"
2016,Jul,7295,7004,291,4.0,"Faribault County, MN"
2016,Aug,7323,7042,281,3.8,"Faribault County, MN"
2016,Sep,7198,6924,274,3.8,"Faribault County, MN"
2016,Oct,7468,7180,288,3.9,"Faribault County, MN"
2016,Nov,7233,6950,283,3.9,"Faribault County, MN"
2016,Dec,7265,6904,361,5.0,"Faribault County, MN"
2017,Jan,7284,6840,444,6.1,"Faribault County, MN"
2017,Feb,7145,6702,443,6.2,"Faribault County, MN"
2017,Mar,7183,6779,404,5.6,"Faribault County, MN"
2017,Apr,7125,6818,307,4.3,"Faribault County, MN"
2017,May,7105,6841,264,3.7,"Faribault County, MN"
2017,Jun,7308,7021,287,3.9,"Faribault County, MN"
2017,Jul,7211,6948,263,3.6,"Faribault County, MN"
2017,Aug,7193,6921,272,3.8,"Faribault County, MN"
2017,Sep,7126,6903,223,3.1,"Faribault County, MN"
2017,Oct,7283,7085,198,2.7,"Faribault County, MN"
2017,Nov,7037,6811,226,3.2,"Faribault County, MN"
2017,Dec,7070,6770,300,4.2,"Faribault County, MN"
2018,Jan,6905,6537,368,5.3,"Faribault County, MN"
2018,Feb,6910,6559,351,5.1,"Faribault County, MN"
2018,Mar,6914,6578,336,4.9,"Faribault County, MN"
2018,Apr,6937,6665,272,3.9,"Faribault County, MN"
2018,May,6988,6797,191,2.7,"Faribault County, MN"
2018,Jun,7171,6935,236,3.3,"Faribault County, MN"
2018,Jul,7120,6921,199,2.8,"Faribault County, MN"
2018,Aug,6980,6786,194,2.8,"Faribault County, MN"
2018,Sep,7024,6858,166,2.4,"Faribault County, MN"
2018,Oct,7175,7017,158,2.2,"Faribault County, MN"
2018,Nov,6874,6674,200,2.9,"Faribault County, MN"
2018,Dec,6979,6664,315,4.5,"Faribault County, MN"
2019,Jan,6906,6499,407,5.9,"Faribault County, MN"
2019,Feb,6743,6395,348,5.2,"Faribault County, MN"
2019,Mar,6833,6491,342,5.0,"Faribault County, MN"
2019,Apr,6959,6648,311,4.5,"Faribault County, MN"
2019,May,7121,6872,249,3.5,"Faribault County, MN"
2019,Jun,7208,6903,305,4.2,"Faribault County, MN"
2019,Jul,7261,6976,285,3.9,"Faribault County, MN"
2019,Aug,7153,6911,242,3.4,"Faribault County, MN"
2019,Sep,7185,6976,209,2.9,"Faribault County, MN"
2019,Oct,7330,7117,213,2.9,"Faribault County, MN"
2019,Nov,6981,6698,283,4.1,"Faribault County, MN"
2019,Dec,7065,6707,358,5.1,"Faribault County, MN"
2020,Jan,6858,6434,424,6.2,"Faribault County, MN"
2020,Feb,6888,6501,387,5.6,"Faribault County, MN"
2020,Mar,6832,6372,460,6.7,"Faribault County, MN"
2020,Apr,6829,6242,587,8.6,"Faribault County, MN"
2020,May,6966,6280,686,9.8,"Faribault County, MN"
2020,Jun,7366,6815,551,7.5,"Faribault County, MN"
2020,Jul,7642,7158,484,6.3,"Faribault County, MN"
2020,Aug,7420,7048,372,5.0,"Faribault County, MN"
2020,Sep,7230,6881,349,4.8,"Faribault County, MN"
2020,Oct,7522,7192,330,4.4,"Faribault County, MN"
2020,Nov,7138,6790,348,4.9,"Faribault County, MN"
2020,Dec,7151,6780,371,5.2,"Faribault County, MN"
2021,Jan,6898,6473,425,6.2,"Faribault County, MN"
2021,Feb,6845,6456,389,5.7,"Faribault County, MN"
2021,Mar,6754,6407,347,5.1,"Faribault County, MN"
2021,Apr,6749,6454,295,4.4,"Faribault County, MN"
2021,May,6854,6594,260,3.8,"Faribault County, MN"
2021,Jun,7108,6790,318,4.5,"Faribault County, MN"
2021,Jul,7213,6944,269,3.7,"Faribault County, MN"
2021,Aug,7105,6852,253,3.6,"Faribault County, MN"
2021,Sep,7014,6811,203,2.9,"Faribault County, MN"
2021,Oct,7187,7011,176,2.4,"Faribault County, MN"
2021,Nov,6975,6794,181,2.6,"Faribault County, MN"
2021,Dec,7149,6910,239,3.3,"Faribault County, MN"
2022,Jan,7054,6744,310,4.4,"Faribault County, MN"
2022,Feb,7004,6738,266,3.8,"Faribault County, MN"
2022,Mar,6959,6718,241,3.5,"Faribault County, MN"
2022,Apr,6809,6622,187,2.7,"Faribault County, MN"
2022,May,6895,6730,165,2.4,"Faribault County, MN"
2022,Jun,7007,6802,205,2.9,"Faribault County, MN"
2022,Jul,7259,7070,189,2.6,"Faribault County, MN"
2022,Aug,7186,6998,188,2.6,"Faribault County, MN"
2022,Sep,7119,6966,153,2.1,"Faribault County, MN"
2022,Oct,7189,7027,162,2.3,"Faribault County, MN"
2022,Nov,7116,6931,185,2.6,"Faribault County, MN"
2022,Dec,7085,6796,289,4.1,"Faribault County, MN"
2023,Jan,6974,6680,294,4.2,"Faribault County, MN"
2023,Feb,6997,6688,309,4.4,"Faribault County, MN"
2023,Mar,6908,6630,278,4.0,"Faribault County, MN"
2023,Apr,6933,6721,212,3.1,"Faribault County, MN"
2023,May,6946,6750,196,2.8,"Faribault County, MN"
2023,Jun,7111,6853,258,3.6,"Faribault County, MN"
2023,Jul,7251,7040,211,2.9,"Faribault County, MN"
2023,Aug,7346,7129,217,3.0,"Faribault County, MN"
2023,Sep,7251,7107,144,2.0,"Faribault County, MN"
2023,Oct,7318,7176,142,1.9,"Faribault County, MN"
2023,Nov,7104,6966,138,1.9,"Faribault County, MN"
2023,Dec,7031,6818,213,3.0,"Faribault County, MN"
2024,Jan,6992,6711,281,4.0,"Faribault County, MN"
2024,Feb,6953,6658,295,4.2,"Faribault County, MN"
2024,Mar,7075,6816,259,3.7,"Faribault County, MN"
2024,Apr,7100,6875,225,3.2,"Faribault County, MN"
2024,May,6956,6748,208,3.0,"Faribault County, MN"
2024,Jun,7302,6991,311,4.3,"Faribault County, MN"
2024,Jul,7463,7170,293,3.9,"Faribault County, MN"
2024,Aug,7652,7386,266,3.5,"Faribault County, MN"
2024,Sep,7572,7370,202,2.7,"Faribault County, MN"
2024,Oct,7530,7339,191,2.5,"Faribault County, MN"
2024,Nov,7361(P),7126(P),235(P),3.2(P),"Faribault County, MN"
P : Preliminary.,P : Preliminary.,P : Preliminary.,P : Preliminary.,P : Preliminary.,P : Preliminary.,"Faribault County, MN"
2014,Jan,10993,10301,692,6.3,"Fillmore County, MN"
2014,Feb,10930,10241,689,6.3,"Fillmore County, MN"
2014,Mar,11012,10319,693,6.3,"Fillmore County, MN"
2014,Apr,10859,10332,527,4.9,"Fillmore County, MN"
2014,May,10816,10398,418,3.9,"Fillmore County, MN"
2014,Jun,11028,10577,451,4.1,"Fillmore County, MN"
2014,Jul,11309,10867,442,3.9,"Fillmore County, MN"
2014,Aug,11286,10869,417,3.7,"Fillmore County, MN"
2014,Sep,10964,10598,366,3.3,"Fillmore County, MN"
2014,Oct,11166,10818,348,3.1,"Fillmore County, MN"
2014,Nov,11108,10683,425,3.8,"Fillmore County, MN"
2014,Dec,11135,10635,500,4.5,"Fillmore County, MN"
2015,Jan,11439,10750,689,6.0,"Fillmore County, MN"
2015,Feb,11232,10565,667,5.9,"Fillmore County, MN"
2015,Mar,11489,10812,677,5.9,"Fillmore County, MN"
2015,Apr,11232,10774,458,4.1,"Fillmore County, MN"
2015,May,11164,10763,401,3.6,"Fillmore County, MN"
2015,Jun,11545,11098,447,3.9,"Fillmore County, MN"
2015,Jul,11567,11132,435,3.8,"Fillmore County, MN"
2015,Aug,11474,11076,398,3.5,"Fillmore County, MN"
2015,Sep,11250,10904,346,3.1,"Fillmore County, MN"
2015,Oct,11679,11331,348,3.0,"Fillmore County, MN"
2015,Nov,11552,11198,354,3.1,"Fillmore County, MN"
2015,Dec,11563,11072,491,4.2,"Fillmore County, MN"
2016,Jan,11760,11116,644,5.5,"Fillmore County, MN"
2016,Feb,11474,10842,632,5.5,"Fillmore County, MN"
2016,Mar,11639,11024,615,5.3,"Fillmore County, MN"
2016,Apr,11376,10957,419,3.7,"Fillmore County, MN"
2016,May,11303,10948,355,3.1,"Fillmore County, MN"
2016,Jun,11476,11046,430,3.7,"Fillmore County, MN"
2016,Jul,11567,11138,429,3.7,"Fillmore County, MN"
2016,Aug,11469,11057,412,3.6,"Fillmore County, MN"
2016,Sep,11226,10844,382,3.4,"Fillmore County, MN"
2016,Oct,11567,11203,364,3.1,"Fillmore County, MN"
2016,Nov,11537,11162,375,3.3,"Fillmore County, MN"
2016,Dec,11504,10998,506,4.4,"Fillmore County, MN"
2017,Jan,11610,10950,660,5.7,"Fillmore County, MN"
2017,Feb,11419,10814,605,5.3,"Fillmore County, MN"
2017,Mar,11486,10916,570,5.0,"Fillmore County, MN"
2017,Apr,11446,11067,379,3.3,"Fillmore County, MN"
2017,May,11396,11075,321,2.8,"Fillmore County, MN"
2017,Jun,11546,11181,365,3.2,"Fillmore County, MN"
2017,Jul,11608,11258,350,3.0,"Fillmore County, MN"
2017,Aug,11402,11058,344,3.0,"Fillmore County, MN"
2017,Sep,11222,10938,284,2.5,"Fillmore County, MN"
2017,Oct,11517,11252,265,2.3,"Fillmore County, MN"
2017,Nov,11447,11127,320,2.8,"Fillmore County, MN"
2017,Dec,11475,11067,408,3.6,"Fillmore County, MN"
2018,Jan,11415,10857,558,4.9,"Fillmore County, MN"
2018,Feb,11486,10926,560,4.9,"Fillmore County, MN"
2018,Mar,11509,10990,519,4.5,"Fillmore County, MN"
2018,Apr,11442,11053,389,3.4,"Fillmore County, MN"
2018,May,11541,11272,269,2.3,"Fillmore County, MN"
2018,Jun,11607,11263,344,3.0,"Fillmore County, MN"
2018,Jul,11774,11492,282,2.4,"Fillmore County, MN"
2018,Aug,11379,11103,276,2.4,"Fillmore County, MN"
2018,Sep,11354,11116,238,2.1,"Fillmore County, MN"
2018,Oct,11515,11266,249,2.2,"Fillmore County, MN"
2018,Nov,11378,11099,279,2.5,"Fillmore County, MN"
2018,Dec,11524,11073,451,3.9,"Fillmore County, MN"
2019,Jan,11448,10853,595,5.2,"Fillmore County, MN"
2019,Feb,11377,10804,573,5.0,"Fillmore County, MN"
2019,Mar,11419,10857,562,4.9,"Fillmore County, MN"
2019,Apr,11442,11070,372,3.3,"Fillmore County, MN"
2019,May,11567,11287,280,2.4,"Fillmore County, MN"
2019,Jun,11654,11293,361,3.1,"Fillmore County, MN"
2019,Jul,11926,11587,339,2.8,"Fillmore County, MN"
2019,Aug,11608,11296,312,2.7,"Fillmore County, MN"
2019,Sep,11522,11258,264,2.3,"Fillmore County, MN"
2019,Oct,11772,11506,266,2.3,"Fillmore County, MN"
2019,Nov,11520,11236,284,2.5,"Fillmore County, MN"
2019,Dec,11700,11253,447,3.8,"Fillmore County, MN"
2020,Jan,11544,10958,586,5.1,"Fillmore County, MN"
2020,Feb,11563,10990,573,5.0,"Fillmore County, MN"
2020,Mar,11519,10856,663,5.8,"Fillmore County, MN"
2020,Apr,11380,10632,748,6.6,"Fillmore County, MN"
2020,May,11496,10528,968,8.4,"Fillmore County, MN"
2020,Jun,11752,10946,806,6.9,"Fillmore County, MN"
2020,Jul,12258,11552,706,5.8,"Fillmore County, MN"
2020,Aug,12040,11510,530,4.4,"Fillmore County, MN"
2020,Sep,11779,11350,429,3.6,"Fillmore County, MN"
2020,Oct,12154,11750,404,3.3,"Fillmore County, MN"
2020,Nov,11785,11417,368,3.1,"Fillmore County, MN"
2020,Dec,11704,11221,483,4.1,"Fillmore County, MN"
2021,Jan,11544,10928,616,5.3,"Fillmore County, MN"
2021,Feb,11501,10890,611,5.3,"Fillmore County, MN"
2021,Mar,11326,10782,544,4.8,"Fillmore County, MN"
2021,Apr,11263,10912,351,3.1,"Fillmore County, MN"
2021,May,11333,11028,305,2.7,"Fillmore County, MN"
2021,Jun,11470,11100,370,3.2,"Fillmore County, MN"
2021,Jul,11728,11423,305,2.6,"Fillmore County, MN"
2021,Aug,11583,11280,303,2.6,"Fillmore County, MN"
2021,Sep,11340,11078,262,2.3,"Fillmore County, MN"
2021,Oct,11468,11243,225,2.0,"Fillmore County, MN"
2021,Nov,11307,11096,211,1.9,"Fillmore County, MN"
2021,Dec,11553,11251,302,2.6,"Fillmore County, MN"
2022,Jan,11498,11063,435,3.8,"Fillmore County, MN"
2022,Feb,11463,11061,402,3.5,"Fillmore County, MN"
2022,Mar,11385,11023,362,3.2,"Fillmore County, MN"
2022,Apr,11185,10956,229,2.0,"Fillmore County, MN"
2022,May,11230,11029,201,1.8,"Fillmore County, MN"
2022,Jun,11344,11067,277,2.4,"Fillmore County, MN"
2022,Jul,11680,11433,247,2.1,"Fillmore County, MN"
2022,Aug,11535,11270,265,2.3,"Fillmore County, MN"
2022,Sep,11310,11111,199,1.8,"Fillmore County, MN"
2022,Oct,11446,11248,198,1.7,"Fillmore County, MN"
2022,Nov,11284,11057,227,2.0,"Fillmore County, MN"
2022,Dec,11527,11165,362,3.1,"Fillmore County, MN"
2023,Jan,11532,11049,483,4.2,"Fillmore County, MN"
2023,Feb,11585,11079,506,4.4,"Fillmore County, MN"
2023,Mar,11584,11108,476,4.1,"Fillmore County, MN"
2023,Apr,11380,11059,321,2.8,"Fillmore County, MN"
2023,May,11376,11099,277,2.4,"Fillmore County, MN"
2023,Jun,11457,11120,337,2.9,"Fillmore County, MN"
2023,Jul,11645,11325,320,2.7,"Fillmore County, MN"
2023,Aug,11799,11484,315,2.7,"Fillmore County, MN"
2023,Sep,11574,11362,212,1.8,"Fillmore County, MN"
2023,Oct,11725,11525,200,1.7,"Fillmore County, MN"
2023,Nov,11708,11513,195,1.7,"Fillmore County, MN"
2023,Dec,11599,11325,274,2.4,"Fillmore County, MN"
2024,Jan,11736,11306,430,3.7,"Fillmore County, MN"
2024,Feb,11739,11263,476,4.1,"Fillmore County, MN"
2024,Mar,11841,11480,361,3.0,"Fillmore County, MN"
2024,Apr,11821,11546,275,2.3,"Fillmore County, MN"
2024,May,11622,11350,272,2.3,"Fillmore County, MN"
2024,Jun,11933,11582,351,2.9,"Fillmore County, MN"
2024,Jul,12282,11914,368,3.0,"Fillmore County, MN"
2024,Aug,12638,12247,391,3.1,"Fillmore County, MN"
2024,Sep,12492,12220,272,2.2,"Fillmore County, MN"
2024,Oct,12463,12207,256,2.1,"Fillmore County, MN"
2024,Nov,12514(P),12206(P),308(P),2.5(P),"Fillmore County, MN"
P : Preliminary.,P : Preliminary.,P : Preliminary.,P : Preliminary.,P : Preliminary.,P : Preliminary.,"Fillmore County, MN"
2014,Jan,16338,15404,934,5.7,"Freeborn County, MN"
2014,Feb,16200,15291,909,5.6,"Freeborn County, MN"
2014,Mar,16351,15447,904,5.5,"Freeborn County, MN"
2014,Apr,16138,15416,722,4.5,"Freeborn County, MN"
2014,May,16289,15620,669,4.1,"Freeborn County, MN"
2014,Jun,16585,15892,693,4.2,"Freeborn County, MN"
2014,Jul,16160,15485,675,4.2,"Freeborn County, MN"
2014,Aug,16220,15591,629,3.9,"Freeborn County, MN"
2014,Sep,16086,15498,588,3.7,"Freeborn County, MN"
2014,Oct,16398,15807,591,3.6,"Freeborn County, MN"
2014,Nov,16306,15669,637,3.9,"Freeborn County, MN"
2014,Dec,16327,15611,716,4.4,"Freeborn County, MN"
2015,Jan,16518,15716,802,4.9,"Freeborn County, MN"
2015,Feb,16342,15598,744,4.6,"Freeborn County, MN"
2015,Mar,16651,15888,763,4.6,"Freeborn County, MN"
2015,Apr,16384,15785,599,3.7,"Freeborn County, MN"
2015,May,16359,15774,585,3.6,"Freeborn County, MN"
2015,Jun,16801,16147,654,3.9,"Freeborn County, MN"
2015,Jul,16098,15477,621,3.9,"Freeborn County, MN"
2015,Aug,16164,15603,561,3.5,"Freeborn County, MN"
2015,Sep,15981,15479,502,3.1,"Freeborn County, MN"
2015,Oct,16504,15983,521,3.2,"Freeborn County, MN"
2015,Nov,16385,15794,591,3.6,"Freeborn County, MN"
2015,Dec,16411,15773,638,3.9,"Freeborn County, MN"
2016,Jan,16557,15831,726,4.4,"Freeborn County, MN"
2016,Feb,16377,15667,710,4.3,"Freeborn County, MN"
2016,Mar,16568,15859,709,4.3,"Freeborn County, MN"
2016,Apr,16444,15874,570,3.5,"Freeborn County, MN"
2016,May,16352,15825,527,3.2,"Freeborn County, MN"
2016,Jun,16476,15819,657,4.0,"Freeborn County, MN"
2016,Jul,15851,15260,591,3.7,"Freeborn County, MN"
2016,Aug,15785,15217,568,3.6,"Freeborn County, MN"
2016,Sep,15963,15433,530,3.3,"Freeborn County, MN"
2016,Oct,16335,15792,543,3.3,"Freeborn County, MN"
2016,Nov,16337,15726,611,3.7,"Freeborn County, MN"
2016,Dec,16262,15543,719,4.4,"Freeborn County, MN"
2017,Jan,16549,15765,784,4.7,"Freeborn County, MN"
2017,Feb,16454,15730,724,4.4,"Freeborn County, MN"
2017,Mar,16503,15812,691,4.2,"Freeborn County, MN"
2017,Apr,16277,15708,569,3.5,"Freeborn County, MN"
2017,May,16266,15773,493,3.0,"Freeborn County, MN"
2017,Jun,16429,15826,603,3.7,"Freeborn County, MN"
2017,Jul,16150,15617,533,3.3,"Freeborn County, MN"
2017,Aug,15804,15269,535,3.4,"Freeborn County, MN"
2017,Sep,15905,15433,472,3.0,"Freeborn County, MN"
2017,Oct,16167,15658,509,3.1,"Freeborn County, MN"
2017,Nov,16053,15447,606,3.8,"Freeborn County, MN"
2017,Dec,16088,15431,657,4.1,"Freeborn County, MN"
2018,Jan,15924,15232,692,4.3,"Freeborn County, MN"
2018,Feb,16058,15394,664,4.1,"Freeborn County, MN"
2018,Mar,16003,15354,649,4.1,"Freeborn County, MN"
2018,Apr,16104,15599,505,3.1,"Freeborn County, MN"
2018,May,16273,15853,420,2.6,"Freeborn County, MN"
2018,Jun,16324,15798,526,3.2,"Freeborn County, MN"
2018,Jul,16216,15748,468,2.9,"Freeborn County, MN"
2018,Aug,15562,15124,438,2.8,"Freeborn County, MN"
2018,Sep,15865,15465,400,2.5,"Freeborn County, MN"
2018,Oct,16126,15683,443,2.7,"Freeborn County, MN"
2018,Nov,15987,15529,458,2.9,"Freeborn County, MN"
2018,Dec,16076,15408,668,4.2,"Freeborn County, MN"
2019,Jan,16050,15288,762,4.7,"Freeborn County, MN"
2019,Feb,15959,15264,695,4.4,"Freeborn County, MN"
2019,Mar,15999,15301,698,4.4,"Freeborn County, MN"
2019,Apr,16109,15573,536,3.3,"Freeborn County, MN"
2019,May,16313,15853,460,2.8,"Freeborn County, MN"
2019,Jun,16458,15865,593,3.6,"Freeborn County, MN"
2019,Jul,16423,15845,578,3.5,"Freeborn County, MN"
2019,Aug,15812,15315,497,3.1,"Freeborn County, MN"
2019,Sep,16190,15777,413,2.6,"Freeborn County, MN"
2019,Oct,16533,16102,431,2.6,"Freeborn County, MN"
2019,Nov,16157,15646,511,3.2,"Freeborn County, MN"
2019,Dec,16189,15600,589,3.6,"Freeborn County, MN"
2020,Jan,16170,15470,700,4.3,"Freeborn County, MN"
2020,Feb,16174,15538,636,3.9,"Freeborn County, MN"
2020,Mar,16101,15279,822,5.1,"Freeborn County, MN"
2020,Apr,16031,14746,1285,8.0,"Freeborn County, MN"
2020,May,16174,14622,1552,9.6,"Freeborn County, MN"
2020,Jun,16806,15441,1365,8.1,"Freeborn County, MN"
2020,Jul,16866,15691,1175,7.0,"Freeborn County, MN"
2020,Aug,16161,15279,882,5.5,"Freeborn County, MN"
2020,Sep,16485,15718,767,4.7,"Freeborn County, MN"
2020,Oct,16624,15956,668,4.0,"Freeborn County, MN"
2020,Nov,16107,15489,618,3.8,"Freeborn County, MN"
2020,Dec,15942,15216,726,4.6,"Freeborn County, MN"
2021,Jan,15807,14969,838,5.3,"Freeborn County, MN"
2021,Feb,15870,15148,722,4.5,"Freeborn County, MN"
2021,Mar,15866,15133,733,4.6,"Freeborn County, MN"
2021,Apr,15726,15089,637,4.1,"Freeborn County, MN"
2021,May,15839,15290,549,3.5,"Freeborn County, MN"
2021,Jun,15962,15281,681,4.3,"Freeborn County, MN"
2021,Jul,15948,15330,618,3.9,"Freeborn County, MN"
2021,Aug,15512,14924,588,3.8,"Freeborn County, MN"
2021,Sep,15559,15085,474,3.0,"Freeborn County, MN"
2021,Oct,15816,15424,392,2.5,"Freeborn County, MN"
2021,Nov,15765,15402,363,2.3,"Freeborn County, MN"
2021,Dec,16003,15555,448,2.8,"Freeborn County, MN"
2022,Jan,15895,15353,542,3.4,"Freeborn County, MN"
2022,Feb,15879,15408,471,3.0,"Freeborn County, MN"
2022,Mar,15865,15390,475,3.0,"Freeborn County, MN"
2022,Apr,15688,15356,332,2.1,"Freeborn County, MN"
2022,May,15890,15572,318,2.0,"Freeborn County, MN"
2022,Jun,15982,15554,428,2.7,"Freeborn County, MN"
2022,Jul,15967,15577,390,2.4,"Freeborn County, MN"
2022,Aug,15660,15233,427,2.7,"Freeborn County, MN"
2022,Sep,15863,15529,334,2.1,"Freeborn County, MN"
2022,Oct,16048,15717,331,2.1,"Freeborn County, MN"
2022,Nov,15954,15602,352,2.2,"Freeborn County, MN"
2022,Dec,16154,15692,462,2.9,"Freeborn County, MN"
2023,Jan,15962,15457,505,3.2,"Freeborn County, MN"
2023,Feb,15980,15449,531,3.3,"Freeborn County, MN"
2023,Mar,15986,15468,518,3.2,"Freeborn County, MN"
2023,Apr,15791,15413,378,2.4,"Freeborn County, MN"
2023,May,15937,15541,396,2.5,"Freeborn County, MN"
2023,Jun,16046,15535,511,3.2,"Freeborn County, MN"
2023,Jul,15927,15427,500,3.1,"Freeborn County, MN"
2023,Aug,15793,15285,508,3.2,"Freeborn County, MN"
2023,Sep,15888,15544,344,2.2,"Freeborn County, MN"
2023,Oct,16045,15705,340,2.1,"Freeborn County, MN"
2023,Nov,15941,15656,285,1.8,"Freeborn County, MN"
2023,Dec,15751,15362,389,2.5,"Freeborn County, MN"
2024,Jan,15813,15308,505,3.2,"Freeborn County, MN"
2024,Feb,15842,15286,556,3.5,"Freeborn County, MN"
2024,Mar,15968,15498,470,2.9,"Freeborn County, MN"
2024,Apr,15920,15538,382,2.4,"Freeborn County, MN"
2024,May,15778,15396,382,2.4,"Freeborn County, MN"
2024,Jun,16184,15543,641,4.0,"Freeborn County, MN"
2024,Jul,16230,15546,684,4.2,"Freeborn County, MN"
2024,Aug,16128,15560,568,3.5,"Freeborn County, MN"
2024,Sep,16320,15903,417,2.6,"Freeborn County, MN"
2024,Oct,16330,15956,374,2.3,"Freeborn County, MN"
2024,Nov,16289(P),15878(P),411(P),2.5(P),"Freeborn County, MN"
P : Preliminary.,P : Preliminary.,P : Preliminary.,P : Preliminary.,P : Preliminary.,P : Preliminary.,"Freeborn County, MN"
2014,Jan,26780,25362,1418,5.3,"Goodhue County, MN"
2014,Feb,26625,25233,1392,5.2,"Goodhue County, MN"
2014,Mar,26756,25381,1375,5.1,"Goodhue County, MN"
2014,Apr,26535,25439,1096,4.1,"Goodhue County, MN"
2014,May,26703,25707,996,3.7,"Goodhue County, MN"
2014,Jun,26821,25718,1103,4.1,"Goodhue County, MN"
2014,Jul,26970,25922,1048,3.9,"Goodhue County, MN"
2014,Aug,27001,26036,965,3.6,"Goodhue County, MN"
2014,Sep,26729,25858,871,3.3,"Goodhue County, MN"
2014,Oct,26917,26098,819,3.0,"Goodhue County, MN"
2014,Nov,26763,25917,846,3.2,"Goodhue County, MN"
2014,Dec,26847,25808,1039,3.9,"Goodhue County, MN"
2015,Jan,27151,25880,1271,4.7,"Goodhue County, MN"
2015,Feb,26893,25688,1205,4.5,"Goodhue County, MN"
2015,Mar,27182,25974,1208,4.4,"Goodhue County, MN"
2015,Apr,26820,25925,895,3.3,"Goodhue County, MN"
2015,May,26898,26024,874,3.2,"Goodhue County, MN"
2015,Jun,27111,26120,991,3.7,"Goodhue County, MN"
2015,Jul,26963,26027,936,3.5,"Goodhue County, MN"
2015,Aug,26837,25969,868,3.2,"Goodhue County, MN"
2015,Sep,26569,25783,786,3.0,"Goodhue County, MN"
2015,Oct,26996,26234,762,2.8,"Goodhue County, MN"
2015,Nov,26852,26075,777,2.9,"Goodhue County, MN"
2015,Dec,27020,25983,1037,3.8,"Goodhue County, MN"
2016,Jan,27128,25864,1264,4.7,"Goodhue County, MN"
2016,Feb,26965,25753,1212,4.5,"Goodhue County, MN"
2016,Mar,27120,25920,1200,4.4,"Goodhue County, MN"
2016,Apr,26759,25852,907,3.4,"Goodhue County, MN"
2016,May,26768,25951,817,3.1,"Goodhue County, MN"
2016,Jun,26887,25836,1051,3.9,"Goodhue County, MN"
2016,Jul,26815,25803,1012,3.8,"Goodhue County, MN"
2016,Aug,26743,25782,961,3.6,"Goodhue County, MN"
2016,Sep,26509,25665,844,3.2,"Goodhue County, MN"
2016,Oct,26768,25951,817,3.1,"Goodhue County, MN"
2016,Nov,26743,25934,809,3.0,"Goodhue County, MN"
2016,Dec,26756,25686,1070,4.0,"Goodhue County, MN"
2017,Jan,27206,25911,1295,4.8,"Goodhue County, MN"
2017,Feb,27000,25797,1203,4.5,"Goodhue County, MN"
2017,Mar,27127,26034,1093,4.0,"Goodhue County, MN"
2017,Apr,26964,26099,865,3.2,"Goodhue County, MN"
2017,May,26954,26176,778,2.9,"Goodhue County, MN"
2017,Jun,27149,26240,909,3.3,"Goodhue County, MN"
2017,Jul,27045,26226,819,3.0,"Goodhue County, MN"
2017,Aug,26735,25918,817,3.1,"Goodhue County, MN"
2017,Sep,26728,26049,679,2.5,"Goodhue County, MN"
2017,Oct,26831,26237,594,2.2,"Goodhue County, MN"
2017,Nov,26889,26252,637,2.4,"Goodhue County, MN"
2017,Dec,27022,26170,852,3.2,"Goodhue County, MN"
2018,Jan,26822,25754,1068,4.0,"Goodhue County, MN"
2018,Feb,26877,25858,1019,3.8,"Goodhue County, MN"
2018,Mar,26821,25862,959,3.6,"Goodhue County, MN"
2018,Apr,26671,25923,748,2.8,"Goodhue County, MN"
2018,May,26846,26241,605,2.3,"Goodhue County, MN"
2018,Jun,26842,26078,764,2.8,"Goodhue County, MN"
2018,Jul,27060,26353,707,2.6,"Goodhue County, MN"
2018,Aug,26824,26165,659,2.5,"Goodhue County, MN"
2018,Sep,26681,26111,570,2.1,"Goodhue County, MN"
2018,Oct,26742,26187,555,2.1,"Goodhue County, MN"
2018,Nov,26596,26014,582,2.2,"Goodhue County, MN"
2018,Dec,26943,26066,877,3.3,"Goodhue County, MN"
2019,Jan,26883,25770,1113,4.1,"Goodhue County, MN"
2019,Feb,26805,25747,1058,3.9,"Goodhue County, MN"
2019,Mar,26826,25788,1038,3.9,"Goodhue County, MN"
2019,Apr,26863,26055,808,3.0,"Goodhue County, MN"
2019,May,27199,26463,736,2.7,"Goodhue County, MN"
2019,Jun,27519,26638,881,3.2,"Goodhue County, MN"
2019,Jul,27622,26772,850,3.1,"Goodhue County, MN"
2019,Aug,27470,26696,774,2.8,"Goodhue County, MN"
2019,Sep,27267,26650,617,2.3,"Goodhue County, MN"
2019,Oct,27206,26592,614,2.3,"Goodhue County, MN"
2019,Nov,26860,26195,665,2.5,"Goodhue County, MN"
2019,Dec,27143,26213,930,3.4,"Goodhue County, MN"
2020,Jan,27069,25916,1153,4.3,"Goodhue County, MN"
2020,Feb,27109,26026,1083,4.0,"Goodhue County, MN"
2020,Mar,26807,25522,1285,4.8,"Goodhue County, MN"
2020,Apr,25479,23176,2303,9.0,"Goodhue County, MN"
2020,May,25980,22892,3088,11.9,"Goodhue County, MN"
2020,Jun,27232,24876,2356,8.7,"Goodhue County, MN"
2020,Jul,27614,25722,1892,6.9,"Goodhue County, MN"
2020,Aug,27520,26096,1424,5.2,"Goodhue County, MN"
2020,Sep,27082,25837,1245,4.6,"Goodhue County, MN"
2020,Oct,27234,26195,1039,3.8,"Goodhue County, MN"
2020,Nov,26792,25804,988,3.7,"Goodhue County, MN"
2020,Dec,26637,25445,1192,4.5,"Goodhue County, MN"
2021,Jan,26676,25300,1376,5.2,"Goodhue County, MN"
2021,Feb,26509,25173,1336,5.0,"Goodhue County, MN"
2021,Mar,26333,25131,1202,4.6,"Goodhue County, MN"
2021,Apr,26311,25363,948,3.6,"Goodhue County, MN"
2021,May,26410,25561,849,3.2,"Goodhue County, MN"
2021,Jun,26677,25691,986,3.7,"Goodhue County, MN"
2021,Jul,26848,25990,858,3.2,"Goodhue County, MN"
2021,Aug,26769,25928,841,3.1,"Goodhue County, MN"
2021,Sep,26441,25724,717,2.7,"Goodhue County, MN"
2021,Oct,26522,25914,608,2.3,"Goodhue County, MN"
2021,Nov,26333,25767,566,2.1,"Goodhue County, MN"
2021,Dec,26757,26045,712,2.7,"Goodhue County, MN"
2022,Jan,26705,25763,942,3.5,"Goodhue County, MN"
2022,Feb,26581,25766,815,3.1,"Goodhue County, MN"
2022,Mar,26623,25837,786,3.0,"Goodhue County, MN"
2022,Apr,26286,25727,559,2.1,"Goodhue County, MN"
2022,May,26543,26037,506,1.9,"Goodhue County, MN"
2022,Jun,26766,26109,657,2.5,"Goodhue County, MN"
2022,Jul,26948,26351,597,2.2,"Goodhue County, MN"
2022,Aug,26933,26272,661,2.5,"Goodhue County, MN"
2022,Sep,26568,26041,527,2.0,"Goodhue County, MN"
2022,Oct,26531,26019,512,1.9,"Goodhue County, MN"
2022,Nov,26282,25756,526,2.0,"Goodhue County, MN"
2022,Dec,26711,25948,763,2.9,"Goodhue County, MN"
2023,Jan,26785,25906,879,3.3,"Goodhue County, MN"
2023,Feb,26904,25981,923,3.4,"Goodhue County, MN"
2023,Mar,26932,26041,891,3.3,"Goodhue County, MN"
2023,Apr,26768,26076,692,2.6,"Goodhue County, MN"
2023,May,26799,26178,621,2.3,"Goodhue County, MN"
2023,Jun,27212,26381,831,3.1,"Goodhue County, MN"
2023,Jul,27198,26448,750,2.8,"Goodhue County, MN"
2023,Aug,27400,26633,767,2.8,"Goodhue County, MN"
2023,Sep,27045,26484,561,2.1,"Goodhue County, MN"
2023,Oct,27155,26639,516,1.9,"Goodhue County, MN"
2023,Nov,27029,26581,448,1.7,"Goodhue County, MN"
2023,Dec,26976,26289,687,2.5,"Goodhue County, MN"
2024,Jan,27140,26265,875,3.2,"Goodhue County, MN"
2024,Feb,27153,26182,971,3.6,"Goodhue County, MN"
2024,Mar,27331,26492,839,3.1,"Goodhue County, MN"
2024,Apr,27283,26589,694,2.5,"Goodhue County, MN"
2024,May,27054,26349,705,2.6,"Goodhue County, MN"
2024,Jun,27572,26532,1040,3.8,"Goodhue County, MN"
2024,Jul,27746,26742,1004,3.6,"Goodhue County, MN"
2024,Aug,28183,27177,1006,3.6,"Goodhue County, MN"
2024,Sep,27854,27149,705,2.5,"Goodhue County, MN"
2024,Oct,27633,27034,599,2.2,"Goodhue County, MN"
2024,Nov,27592(P),26916(P),676(P),2.4(P),"Goodhue County, MN"
P : Preliminary.,P : Preliminary.,P : Preliminary.,P : Preliminary.,P : Preliminary.,P : Preliminary.,"Goodhue County, MN"
2014,Jan,3258,2999,259,7.9,"Grant County, MN"
2014,Feb,3233,2976,257,7.9,"Grant County, MN"
2014,Mar,3270,3012,258,7.9,"Grant County, MN"
2014,Apr,3186,3004,182,5.7,"Grant County, MN"
2014,May,3263,3133,130,4.0,"Grant County, MN"
2014,Jun,3369,3226,143,4.2,"Grant County, MN"
2014,Jul,3297,3161,136,4.1,"Grant County, MN"
2014,Aug,3285,3163,122,3.7,"Grant County, MN"
2014,Sep,3246,3138,108,3.3,"Grant County, MN"
2014,Oct,3367,3274,93,2.8,"Grant County, MN"
2014,Nov,3338,3213,125,3.7,"Grant County, MN"
2014,Dec,3362,3167,195,5.8,"Grant County, MN"
2015,Jan,3358,3121,237,7.1,"Grant County, MN"
2015,Feb,3294,3066,228,6.9,"Grant County, MN"
2015,Mar,3372,3135,237,7.0,"Grant County, MN"
2015,Apr,3371,3214,157,4.7,"Grant County, MN"
2015,May,3349,3211,138,4.1,"Grant County, MN"
2015,Jun,3437,3303,134,3.9,"Grant County, MN"
2015,Jul,3332,3195,137,4.1,"Grant County, MN"
2015,Aug,3281,3160,121,3.7,"Grant County, MN"
2015,Sep,3227,3121,106,3.3,"Grant County, MN"
2015,Oct,3412,3311,101,3.0,"Grant County, MN"
2015,Nov,3389,3255,134,4.0,"Grant County, MN"
2015,Dec,3443,3241,202,5.9,"Grant County, MN"
2016,Jan,3384,3152,232,6.9,"Grant County, MN"
2016,Feb,3278,3054,224,6.8,"Grant County, MN"
2016,Mar,3331,3107,224,6.7,"Grant County, MN"
2016,Apr,3309,3166,143,4.3,"Grant County, MN"
2016,May,3295,3186,109,3.3,"Grant County, MN"
2016,Jun,3299,3170,129,3.9,"Grant County, MN"
2016,Jul,3215,3093,122,3.8,"Grant County, MN"
2016,Aug,3203,3076,127,4.0,"Grant County, MN"
2016,Sep,3173,3062,111,3.5,"Grant County, MN"
2016,Oct,3300,3194,106,3.2,"Grant County, MN"
2016,Nov,3291,3171,120,3.6,"Grant County, MN"
2016,Dec,3341,3146,195,5.8,"Grant County, MN"
2017,Jan,3361,3116,245,7.3,"Grant County, MN"
2017,Feb,3256,3035,221,6.8,"Grant County, MN"
2017,Mar,3286,3077,209,6.4,"Grant County, MN"
2017,Apr,3285,3152,133,4.0,"Grant County, MN"
2017,May,3291,3185,106,3.2,"Grant County, MN"
2017,Jun,3356,3242,114,3.4,"Grant County, MN"
2017,Jul,3306,3204,102,3.1,"Grant County, MN"
2017,Aug,3201,3106,95,3.0,"Grant County, MN"
2017,Sep,3173,3097,76,2.4,"Grant County, MN"
2017,Oct,3361,3293,68,2.0,"Grant County, MN"
2017,Nov,3329,3220,109,3.3,"Grant County, MN"
2017,Dec,3344,3187,157,4.7,"Grant County, MN"
2018,Jan,3285,3083,202,6.1,"Grant County, MN"
2018,Feb,3278,3087,191,5.8,"Grant County, MN"
2018,Mar,3281,3084,197,6.0,"Grant County, MN"
2018,Apr,3338,3180,158,4.7,"Grant County, MN"
2018,May,3404,3298,106,3.1,"Grant County, MN"
2018,Jun,3416,3303,113,3.3,"Grant County, MN"
2018,Jul,3319,3201,118,3.6,"Grant County, MN"
2018,Aug,3213,3113,100,3.1,"Grant County, MN"
2018,Sep,3196,3120,76,2.4,"Grant County, MN"
2018,Oct,3309,3225,84,2.5,"Grant County, MN"
2018,Nov,3238,3136,102,3.2,"Grant County, MN"
2018,Dec,3352,3170,182,5.4,"Grant County, MN"
2019,Jan,3257,3023,234,7.2,"Grant County, MN"
2019,Feb,3227,3023,204,6.3,"Grant County, MN"
2019,Mar,3267,3070,197,6.0,"Grant County, MN"
2019,Apr,3347,3192,155,4.6,"Grant County, MN"
2019,May,3378,3266,112,3.3,"Grant County, MN"
2019,Jun,3361,3225,136,4.0,"Grant County, MN"
2019,Jul,3393,3257,136,4.0,"Grant County, MN"
2019,Aug,3264,3149,115,3.5,"Grant County, MN"
2019,Sep,3277,3173,104,3.2,"Grant County, MN"
2019,Oct,3435,3329,106,3.1,"Grant County, MN"
2019,Nov,3342,3229,113,3.4,"Grant County, MN"
2019,Dec,3387,3206,181,5.3,"Grant County, MN"
2020,Jan,3272,3044,228,7.0,"Grant County, MN"
2020,Feb,3263,3064,199,6.1,"Grant County, MN"
2020,Mar,3235,3009,226,7.0,"Grant County, MN"
2020,Apr,3286,3067,219,6.7,"Grant County, MN"
2020,May,3273,3057,216,6.6,"Grant County, MN"
2020,Jun,3433,3227,206,6.0,"Grant County, MN"
2020,Jul,3452,3264,188,5.4,"Grant County, MN"
2020,Aug,3407,3271,136,4.0,"Grant County, MN"
2020,Sep,3393,3261,132,3.9,"Grant County, MN"
2020,Oct,3527,3411,116,3.3,"Grant County, MN"
2020,Nov,3386,3261,125,3.7,"Grant County, MN"
2020,Dec,3421,3244,177,5.2,"Grant County, MN"
2021,Jan,3267,3063,204,6.2,"Grant County, MN"
2021,Feb,3261,3076,185,5.7,"Grant County, MN"
2021,Mar,3227,3047,180,5.6,"Grant County, MN"
2021,Apr,3279,3144,135,4.1,"Grant County, MN"
2021,May,3288,3183,105,3.2,"Grant County, MN"
2021,Jun,3318,3178,140,4.2,"Grant County, MN"
2021,Jul,3340,3216,124,3.7,"Grant County, MN"
2021,Aug,3261,3145,116,3.6,"Grant County, MN"
2021,Sep,3225,3137,88,2.7,"Grant County, MN"
2021,Oct,3291,3223,68,2.1,"Grant County, MN"
2021,Nov,3278,3201,77,2.3,"Grant County, MN"
2021,Dec,3331,3200,131,3.9,"Grant County, MN"
2022,Jan,3249,3094,155,4.8,"Grant County, MN"
2022,Feb,3221,3089,132,4.1,"Grant County, MN"
2022,Mar,3204,3079,125,3.9,"Grant County, MN"
2022,Apr,3211,3117,94,2.9,"Grant County, MN"
2022,May,3302,3233,69,2.1,"Grant County, MN"
2022,Jun,3284,3210,74,2.3,"Grant County, MN"
2022,Jul,3286,3213,73,2.2,"Grant County, MN"
2022,Aug,3252,3184,68,2.1,"Grant County, MN"
2022,Sep,3232,3183,49,1.5,"Grant County, MN"
2022,Oct,3322,3273,49,1.5,"Grant County, MN"
2022,Nov,3259,3183,76,2.3,"Grant County, MN"
2022,Dec,3348,3226,122,3.6,"Grant County, MN"
2023,Jan,3259,3115,144,4.4,"Grant County, MN"
2023,Feb,3276,3127,149,4.5,"Grant County, MN"
2023,Mar,3276,3139,137,4.2,"Grant County, MN"
2023,Apr,3253,3141,112,3.4,"Grant County, MN"
2023,May,3254,3175,79,2.4,"Grant County, MN"
2023,Jun,3281,3178,103,3.1,"Grant County, MN"
2023,Jul,3224,3123,101,3.1,"Grant County, MN"
2023,Aug,3295,3192,103,3.1,"Grant County, MN"
2023,Sep,3196,3130,66,2.1,"Grant County, MN"
2023,Oct,3279,3220,59,1.8,"Grant County, MN"
2023,Nov,3267,3192,75,2.3,"Grant County, MN"
2023,Dec,3242,3113,129,4.0,"Grant County, MN"
2024,Jan,3184,3015,169,5.3,"Grant County, MN"
2024,Feb,3177,3000,177,5.6,"Grant County, MN"
2024,Mar,3235,3081,154,4.8,"Grant County, MN"
2024,Apr,3263,3153,110,3.4,"Grant County, MN"
2024,May,3226,3110,116,3.6,"Grant County, MN"
2024,Jun,3300,3156,144,4.4,"Grant County, MN"
2024,Jul,3288,3149,139,4.2,"Grant County, MN"
2024,Aug,3395,3259,136,4.0,"Grant County, MN"
2024,Sep,3328,3246,82,2.5,"Grant County, MN"
2024,Oct,3359,3278,81,2.4,"Grant County, MN"
2024,Nov,3352(P),3251(P),101(P),3.0(P),"Grant County, MN"
P : Preliminary.,P : Preliminary.,P : Preliminary.,P : Preliminary.,P : Preliminary.,P : Preliminary.,"Grant County, MN"
2014,Jan,665198,634763,30435,4.6,"Hennepin County, MN"
2014,Feb,666106,635902,30204,4.5,"Hennepin County, MN"
2014,Mar,668965,638516,30449,4.6,"Hennepin County, MN"
2014,Apr,671022,645695,25327,3.8,"Hennepin County, MN"
2014,May,676180,650685,25495,3.8,"Hennepin County, MN"
2014,Jun,681189,652890,28299,4.2,"Hennepin County, MN"
2014,Jul,683118,655635,27483,4.0,"Hennepin County, MN"
2014,Aug,677353,651175,26178,3.9,"Hennepin County, MN"
2014,Sep,674814,650830,23984,3.6,"Hennepin County, MN"
2014,Oct,675539,653568,21971,3.3,"Hennepin County, MN"
2014,Nov,675674,654129,21545,3.2,"Hennepin County, MN"
2014,Dec,671795,649708,22087,3.3,"Hennepin County, MN"
2015,Jan,668387,642958,25429,3.8,"Hennepin County, MN"
2015,Feb,671892,647326,24566,3.7,"Hennepin County, MN"
2015,Mar,670335,645757,24578,3.7,"Hennepin County, MN"
2015,Apr,677568,656100,21468,3.2,"Hennepin County, MN"
2015,May,685540,662696,22844,3.3,"Hennepin County, MN"
2015,Jun,684229,659186,25043,3.7,"Hennepin County, MN"
2015,Jul,689317,664839,24478,3.6,"Hennepin County, MN"
2015,Aug,684057,661098,22959,3.4,"Hennepin County, MN"
2015,Sep,678027,656642,21385,3.2,"Hennepin County, MN"
2015,Oct,676081,655570,20511,3.0,"Hennepin County, MN"
2015,Nov,678119,658565,19554,2.9,"Hennepin County, MN"
2015,Dec,677088,656625,20463,3.0,"Hennepin County, MN"
2016,Jan,673444,650024,23420,3.5,"Hennepin County, MN"
2016,Feb,680824,657252,23572,3.5,"Hennepin County, MN"
2016,Mar,679300,655104,24196,3.6,"Hennepin County, MN"
2016,Apr,683463,662475,20988,3.1,"Hennepin County, MN"
2016,May,685875,665436,20439,3.0,"Hennepin County, MN"
2016,Jun,687939,662915,25024,3.6,"Hennepin County, MN"
2016,Jul,696094,672134,23960,3.4,"Hennepin County, MN"
2016,Aug,692548,668493,24055,3.5,"Hennepin County, MN"
2016,Sep,690667,667755,22912,3.3,"Hennepin County, MN"
2016,Oct,685112,662963,22149,3.2,"Hennepin County, MN"
2016,Nov,683430,662834,20596,3.0,"Hennepin County, MN"
2016,Dec,682576,660189,22387,3.3,"Hennepin County, MN"
2017,Jan,686637,662501,24136,3.5,"Hennepin County, MN"
2017,Feb,692749,668875,23874,3.4,"Hennepin County, MN"
2017,Mar,694842,672404,22438,3.2,"Hennepin County, MN"
2017,Apr,698186,677439,20747,3.0,"Hennepin County, MN"
2017,May,700594,679486,21108,3.0,"Hennepin County, MN"
2017,Jun,708727,684147,24580,3.5,"Hennepin County, MN"
2017,Jul,714689,691336,23353,3.3,"Hennepin County, MN"
2017,Aug,710468,687100,23368,3.3,"Hennepin County, MN"
2017,Sep,710351,690222,20129,2.8,"Hennepin County, MN"
2017,Oct,700798,682929,17869,2.5,"Hennepin County, MN"
2017,Nov,702411,684813,17598,2.5,"Hennepin County, MN"
2017,Dec,699917,681028,18889,2.7,"Hennepin County, MN"
2018,Jan,697241,677511,19730,2.8,"Hennepin County, MN"
2018,Feb,702922,683039,19883,2.8,"Hennepin County, MN"
2018,Mar,698927,679343,19584,2.8,"Hennepin County, MN"
2018,Apr,697678,681072,16606,2.4,"Hennepin County, MN"
2018,May,701052,685115,15937,2.3,"Hennepin County, MN"
2018,Jun,708517,687657,20860,2.9,"Hennepin County, MN"
2018,Jul,712392,693180,19212,2.7,"Hennepin County, MN"
2018,Aug,707449,688597,18852,2.7,"Hennepin County, MN"
2018,Sep,704163,687582,16581,2.4,"Hennepin County, MN"
2018,Oct,703655,687691,15964,2.3,"Hennepin County, MN"
2018,Nov,705169,689965,15204,2.2,"Hennepin County, MN"
2018,Dec,705638,686793,18845,2.7,"Hennepin County, MN"
2019,Jan,703727,682752,20975,3.0,"Hennepin County, MN"
2019,Feb,706651,686596,20055,2.8,"Hennepin County, MN"
2019,Mar,705302,684201,21101,3.0,"Hennepin County, MN"
2019,Apr,703742,686300,17442,2.5,"Hennepin County, MN"
2019,May,707474,688282,19192,2.7,"Hennepin County, MN"
2019,Jun,716636,693124,23512,3.3,"Hennepin County, MN"
2019,Jul,720694,697988,22706,3.2,"Hennepin County, MN"
2019,Aug,719210,697521,21689,3.0,"Hennepin County, MN"
2019,Sep,715491,696992,18499,2.6,"Hennepin County, MN"
2019,Oct,714282,695325,18957,2.7,"Hennepin County, MN"
2019,Nov,715119,697427,17692,2.5,"Hennepin County, MN"
2019,Dec,714789,696260,18529,2.6,"Hennepin County, MN"
2020,Jan,713531,694745,18786,2.6,"Hennepin County, MN"
2020,Feb,717435,698102,19333,2.7,"Hennepin County, MN"
2020,Mar,714341,687503,26838,3.8,"Hennepin County, MN"
2020,Apr,682124,620840,61284,9.0,"Hennepin County, MN"
2020,May,699632,613168,86464,12.4,"Hennepin County, MN"
2020,Jun,731310,654564,76746,10.5,"Hennepin County, MN"
2020,Jul,737566,667173,70393,9.5,"Hennepin County, MN"
2020,Aug,735260,679589,55671,7.6,"Hennepin County, MN"
2020,Sep,726200,675766,50434,6.9,"Hennepin County, MN"
2020,Oct,718402,678689,39713,5.5,"Hennepin County, MN"
2020,Nov,710584,679777,30807,4.3,"Hennepin County, MN"
2020,Dec,696239,663462,32777,4.7,"Hennepin County, MN"
2021,Jan,688210,656022,32188,4.7,"Hennepin County, MN"
2021,Feb,689194,659635,29559,4.3,"Hennepin County, MN"
2021,Mar,690402,660652,29750,4.3,"Hennepin County, MN"
2021,Apr,694452,665635,28817,4.1,"Hennepin County, MN"
2021,May,695980,668178,27802,4.0,"Hennepin County, MN"
2021,Jun,699383,666718,32665,4.7,"Hennepin County, MN"
2021,Jul,702309,674599,27710,3.9,"Hennepin County, MN"
2021,Aug,697898,671547,26351,3.8,"Hennepin County, MN"
2021,Sep,694543,670447,24096,3.5,"Hennepin County, MN"
2021,Oct,695060,674493,20567,3.0,"Hennepin County, MN"
2021,Nov,697434,680624,16810,2.4,"Hennepin County, MN"
2021,Dec,694706,677422,17284,2.5,"Hennepin County, MN"
2022,Jan,694156,674489,19667,2.8,"Hennepin County, MN"
2022,Feb,695443,678112,17331,2.5,"Hennepin County, MN"
2022,Mar,696819,679544,17275,2.5,"Hennepin County, MN"
2022,Apr,700594,687603,12991,1.9,"Hennepin County, MN"
2022,May,705572,691072,14500,2.1,"Hennepin County, MN"
2022,Jun,706754,687836,18918,2.7,"Hennepin County, MN"
2022,Jul,709321,691762,17559,2.5,"Hennepin County, MN"
2022,Aug,709568,690805,18763,2.6,"Hennepin County, MN"
2022,Sep,705520,689801,15719,2.2,"Hennepin County, MN"
2022,Oct,699777,684409,15368,2.2,"Hennepin County, MN"
2022,Nov,698654,684042,14612,2.1,"Hennepin County, MN"
2022,Dec,698681,682077,16604,2.4,"Hennepin County, MN"
2023,Jan,698641,680981,17660,2.5,"Hennepin County, MN"
2023,Feb,701326,682498,18828,2.7,"Hennepin County, MN"
2023,Mar,704078,685618,18460,2.6,"Hennepin County, MN"
2023,Apr,707819,691035,16784,2.4,"Hennepin County, MN"
2023,May,712493,693676,18817,2.6,"Hennepin County, MN"
2023,Jun,719707,696998,22709,3.2,"Hennepin County, MN"
2023,Jul,719619,698660,20959,2.9,"Hennepin County, MN"
2023,Aug,713490,691518,21972,3.1,"Hennepin County, MN"
2023,Sep,709905,692113,17792,2.5,"Hennepin County, MN"
2023,Oct,706404,689489,16915,2.4,"Hennepin County, MN"
2023,Nov,704160,691110,13050,1.9,"Hennepin County, MN"
2023,Dec,700268,684843,15425,2.2,"Hennepin County, MN"
2024,Jan,701543,683014,18529,2.6,"Hennepin County, MN"
2024,Feb,706237,685093,21144,3.0,"Hennepin County, MN"
2024,Mar,705574,687327,18247,2.6,"Hennepin County, MN"
2024,Apr,707398,690404,16994,2.4,"Hennepin County, MN"
2024,May,704927,687966,16961,2.4,"Hennepin County, MN"
2024,Jun,703394,678137,25257,3.6,"Hennepin County, MN"
2024,Jul,705655,679608,26047,3.7,"Hennepin County, MN"
2024,Aug,701912,674966,26946,3.8,"Hennepin County, MN"
2024,Sep,700300,678405,21895,3.1,"Hennepin County, MN"
2024,Oct,701406,681850,19556,2.8,"Hennepin County, MN"
2024,Nov,699826(P),679325(P),20501(P),2.9(P),"Hennepin County, MN"
P : Preliminary.,P : Preliminary.,P : Preliminary.,P : Preliminary.,P : Preliminary.,P : Preliminary.,"Hennepin County, MN"
2014,Jan,10326,9642,684,6.6,"Houston County, MN"
2014,Feb,10449,9772,677,6.5,"Houston County, MN"
2014,Mar,10480,9824,656,6.3,"Houston County, MN"
2014,Apr,10400,9885,515,5.0,"Houston County, MN"
2014,May,10290,9878,412,4.0,"Houston County, MN"
2014,Jun,10240,9804,436,4.3,"Houston County, MN"
2014,Jul,10306,9894,412,4.0,"Houston County, MN"
2014,Aug,10251,9872,379,3.7,"Houston County, MN"
2014,Sep,10309,9971,338,3.3,"Houston County, MN"
2014,Oct,10480,10157,323,3.1,"Houston County, MN"
2014,Nov,10493,10140,353,3.4,"Houston County, MN"
2014,Dec,10526,10074,452,4.3,"Houston County, MN"
2015,Jan,10531,9924,607,5.8,"Houston County, MN"
2015,Feb,10584,10010,574,5.4,"Houston County, MN"
2015,Mar,10691,10151,540,5.1,"Houston County, MN"
2015,Apr,10554,10189,365,3.5,"Houston County, MN"
2015,May,10450,10109,341,3.3,"Houston County, MN"
2015,Jun,10459,10084,375,3.6,"Houston County, MN"
2015,Jul,10387,10009,378,3.6,"Houston County, MN"
2015,Aug,10272,9936,336,3.3,"Houston County, MN"
2015,Sep,10307,10019,288,2.8,"Houston County, MN"
2015,Oct,10609,10303,306,2.9,"Houston County, MN"
2015,Nov,10579,10244,335,3.2,"Houston County, MN"
2015,Dec,10686,10227,459,4.3,"Houston County, MN"
2016,Jan,10644,10029,615,5.8,"Houston County, MN"
2016,Feb,10704,10106,598,5.6,"Houston County, MN"
2016,Mar,10737,10191,546,5.1,"Houston County, MN"
2016,Apr,10659,10287,372,3.5,"Houston County, MN"
2016,May,10499,10189,310,3.0,"Houston County, MN"
2016,Jun,10462,10104,358,3.4,"Houston County, MN"
2016,Jul,10494,10142,352,3.4,"Houston County, MN"
2016,Aug,10357,10015,342,3.3,"Houston County, MN"
2016,Sep,10423,10093,330,3.2,"Houston County, MN"
2016,Oct,10675,10341,334,3.1,"Houston County, MN"
2016,Nov,10730,10396,334,3.1,"Houston County, MN"
2016,Dec,10739,10257,482,4.5,"Houston County, MN"
2017,Jan,10582,9946,636,6.0,"Houston County, MN"
2017,Feb,10667,10109,558,5.2,"Houston County, MN"
2017,Mar,10688,10175,513,4.8,"Houston County, MN"
2017,Apr,10651,10293,358,3.4,"Houston County, MN"
2017,May,10534,10229,305,2.9,"Houston County, MN"
2017,Jun,10472,10128,344,3.3,"Houston County, MN"
2017,Jul,10352,10051,301,2.9,"Houston County, MN"
2017,Aug,10196,9916,280,2.7,"Houston County, MN"
2017,Sep,10332,10080,252,2.4,"Houston County, MN"
2017,Oct,10515,10290,225,2.1,"Houston County, MN"
2017,Nov,10508,10264,244,2.3,"Houston County, MN"
2017,Dec,10546,10199,347,3.3,"Houston County, MN"
2018,Jan,10370,9886,484,4.7,"Houston County, MN"
2018,Feb,10622,10151,471,4.4,"Houston County, MN"
2018,Mar,10442,10013,429,4.1,"Houston County, MN"
2018,Apr,10477,10154,323,3.1,"Houston County, MN"
2018,May,10467,10226,241,2.3,"Houston County, MN"
2018,Jun,10370,10096,274,2.6,"Houston County, MN"
2018,Jul,10366,10125,241,2.3,"Houston County, MN"
2018,Aug,10137,9904,233,2.3,"Houston County, MN"
2018,Sep,10277,10061,216,2.1,"Houston County, MN"
2018,Oct,10428,10212,216,2.1,"Houston County, MN"
2018,Nov,10399,10194,205,2.0,"Houston County, MN"
2018,Dec,10516,10157,359,3.4,"Houston County, MN"
2019,Jan,10331,9825,506,4.9,"Houston County, MN"
2019,Feb,10457,9991,466,4.5,"Houston County, MN"
2019,Mar,10473,10000,473,4.5,"Houston County, MN"
2019,Apr,10491,10167,324,3.1,"Houston County, MN"
2019,May,10454,10197,257,2.5,"Houston County, MN"
2019,Jun,10365,10039,326,3.1,"Houston County, MN"
2019,Jul,10462,10158,304,2.9,"Houston County, MN"
2019,Aug,10279,10002,277,2.7,"Houston County, MN"
2019,Sep,10412,10139,273,2.6,"Houston County, MN"
2019,Oct,10580,10334,246,2.3,"Houston County, MN"
2019,Nov,10476,10228,248,2.4,"Houston County, MN"
2019,Dec,10564,10197,367,3.5,"Houston County, MN"
2020,Jan,10355,9874,481,4.6,"Houston County, MN"
2020,Feb,10575,10115,460,4.3,"Houston County, MN"
2020,Mar,10548,9994,554,5.3,"Houston County, MN"
2020,Apr,9855,9247,608,6.2,"Houston County, MN"
2020,May,9916,9240,676,6.8,"Houston County, MN"
2020,Jun,10389,9824,565,5.4,"Houston County, MN"
2020,Jul,10574,10078,496,4.7,"Houston County, MN"
2020,Aug,10430,10064,366,3.5,"Houston County, MN"
2020,Sep,10495,10182,313,3.0,"Houston County, MN"
2020,Oct,10685,10401,284,2.7,"Houston County, MN"
2020,Nov,10539,10267,272,2.6,"Houston County, MN"
2020,Dec,10561,10195,366,3.5,"Houston County, MN"
2021,Jan,10365,9878,487,4.7,"Houston County, MN"
2021,Feb,10508,9990,518,4.9,"Houston County, MN"
2021,Mar,10419,9957,462,4.4,"Houston County, MN"
2021,Apr,10400,10084,316,3.0,"Houston County, MN"
2021,May,10356,10062,294,2.8,"Houston County, MN"
2021,Jun,10305,9957,348,3.4,"Houston County, MN"
2021,Jul,10414,10148,266,2.6,"Houston County, MN"
2021,Aug,10301,10043,258,2.5,"Houston County, MN"
2021,Sep,10353,10135,218,2.1,"Houston County, MN"
2021,Oct,10431,10248,183,1.8,"Houston County, MN"
2021,Nov,10379,10196,183,1.8,"Houston County, MN"
2021,Dec,10512,10256,256,2.4,"Houston County, MN"
2022,Jan,10186,9828,358,3.5,"Houston County, MN"
2022,Feb,10353,10031,322,3.1,"Houston County, MN"
2022,Mar,10339,10034,305,2.9,"Houston County, MN"
2022,Apr,10205,10023,182,1.8,"Houston County, MN"
2022,May,10132,9973,159,1.6,"Houston County, MN"
2022,Jun,10008,9797,211,2.1,"Houston County, MN"
2022,Jul,10191,10000,191,1.9,"Houston County, MN"
2022,Aug,10173,9984,189,1.9,"Houston County, MN"
2022,Sep,10310,10141,169,1.6,"Houston County, MN"
2022,Oct,10425,10266,159,1.5,"Houston County, MN"
2022,Nov,10323,10150,173,1.7,"Houston County, MN"
2022,Dec,10545,10246,299,2.8,"Houston County, MN"
2023,Jan,10325,9940,385,3.7,"Houston County, MN"
2023,Feb,10556,10154,402,3.8,"Houston County, MN"
2023,Mar,10568,10205,363,3.4,"Houston County, MN"
2023,Apr,10491,10238,253,2.4,"Houston County, MN"
2023,May,10383,10154,229,2.2,"Houston County, MN"
2023,Jun,10260,9994,266,2.6,"Houston County, MN"
2023,Jul,10341,10101,240,2.3,"Houston County, MN"
2023,Aug,10483,10230,253,2.4,"Houston County, MN"
2023,Sep,10550,10351,199,1.9,"Houston County, MN"
2023,Oct,10614,10431,183,1.7,"Houston County, MN"
2023,Nov,10600,10444,156,1.5,"Houston County, MN"
2023,Dec,10573,10348,225,2.1,"Houston County, MN"
2024,Jan,10520,10159,361,3.4,"Houston County, MN"
2024,Feb,10664,10276,388,3.6,"Houston County, MN"
2024,Mar,10741,10430,311,2.9,"Houston County, MN"
2024,Apr,10746,10493,253,2.4,"Houston County, MN"
2024,May,10459,10201,258,2.5,"Houston County, MN"
2024,Jun,10473,10126,347,3.3,"Houston County, MN"
2024,Jul,10571,10264,307,2.9,"Houston County, MN"
2024,Aug,10751,10456,295,2.7,"Houston County, MN"
2024,Sep,10815,10567,248,2.3,"Houston County, MN"
2024,Oct,10811,10588,223,2.1,"Houston County, MN"
2024,Nov,10837(P),10572(P),265(P),2.4(P),"Houston County, MN"
P : Preliminary.,P : Preliminary.,P : Preliminary.,P : Preliminary.,P : Preliminary.,P : Preliminary.,"Houston County, MN"
2014,Jan,9133,8265,868,9.5,"Hubbard County, MN"
2014,Feb,9125,8280,845,9.3,"Hubbard County, MN"
2014,Mar,9197,8361,836,9.1,"Hubbard County, MN"
2014,Apr,9269,8601,668,7.2,"Hubbard County, MN"
2014,May,9576,9050,526,5.5,"Hubbard County, MN"
2014,Jun,9885,9330,555,5.6,"Hubbard County, MN"
2014,Jul,9902,9387,515,5.2,"Hubbard County, MN"
2014,Aug,9769,9283,486,5.0,"Hubbard County, MN"
2014,Sep,9625,9201,424,4.4,"Hubbard County, MN"
2014,Oct,9420,8988,432,4.6,"Hubbard County, MN"
2014,Nov,9323,8748,575,6.2,"Hubbard County, MN"
2014,Dec,9330,8639,691,7.4,"Hubbard County, MN"
2015,Jan,9284,8482,802,8.6,"Hubbard County, MN"
2015,Feb,9228,8467,761,8.2,"Hubbard County, MN"
2015,Mar,9307,8544,763,8.2,"Hubbard County, MN"
2015,Apr,9424,8831,593,6.3,"Hubbard County, MN"
2015,May,9724,9194,530,5.5,"Hubbard County, MN"
2015,Jun,10005,9467,538,5.4,"Hubbard County, MN"
2015,Jul,10126,9617,509,5.0,"Hubbard County, MN"
2015,Aug,9802,9333,469,4.8,"Hubbard County, MN"
2015,Sep,9595,9179,416,4.3,"Hubbard County, MN"
2015,Oct,9501,9051,450,4.7,"Hubbard County, MN"
2015,Nov,9393,8802,591,6.3,"Hubbard County, MN"
2015,Dec,9600,8835,765,8.0,"Hubbard County, MN"
2016,Jan,9513,8702,811,8.5,"Hubbard County, MN"
2016,Feb,9497,8689,808,8.5,"Hubbard County, MN"
2016,Mar,9543,8714,829,8.7,"Hubbard County, MN"
2016,Apr,9697,9069,628,6.5,"Hubbard County, MN"
2016,May,9871,9357,514,5.2,"Hubbard County, MN"
2016,Jun,10266,9685,581,5.7,"Hubbard County, MN"
2016,Jul,10357,9819,538,5.2,"Hubbard County, MN"
2016,Aug,10086,9546,540,5.4,"Hubbard County, MN"
2016,Sep,9882,9397,485,4.9,"Hubbard County, MN"
2016,Oct,9632,9115,517,5.4,"Hubbard County, MN"
2016,Nov,9501,8894,607,6.4,"Hubbard County, MN"
2016,Dec,9628,8858,770,8.0,"Hubbard County, MN"
2017,Jan,9716,8828,888,9.1,"Hubbard County, MN"
2017,Feb,9688,8877,811,8.4,"Hubbard County, MN"
2017,Mar,9666,8922,744,7.7,"Hubbard County, MN"
2017,Apr,9610,9060,550,5.7,"Hubbard County, MN"
2017,May,9914,9484,430,4.3,"Hubbard County, MN"
2017,Jun,10270,9802,468,4.6,"Hubbard County, MN"
2017,Jul,10275,9835,440,4.3,"Hubbard County, MN"
2017,Aug,10065,9635,430,4.3,"Hubbard County, MN"
2017,Sep,9997,9643,354,3.5,"Hubbard County, MN"
2017,Oct,9754,9420,334,3.4,"Hubbard County, MN"
2017,Nov,9726,9143,583,6.0,"Hubbard County, MN"
2017,Dec,9734,9057,677,7.0,"Hubbard County, MN"
2018,Jan,9638,8881,757,7.9,"Hubbard County, MN"
2018,Feb,9663,8953,710,7.3,"Hubbard County, MN"
2018,Mar,9626,8961,665,6.9,"Hubbard County, MN"
2018,Apr,9696,9173,523,5.4,"Hubbard County, MN"
2018,May,9911,9539,372,3.8,"Hubbard County, MN"
2018,Jun,10342,9914,428,4.1,"Hubbard County, MN"
2018,Jul,10410,10033,377,3.6,"Hubbard County, MN"
2018,Aug,10087,9735,352,3.5,"Hubbard County, MN"
2018,Sep,9952,9647,305,3.1,"Hubbard County, MN"
2018,Oct,9777,9425,352,3.6,"Hubbard County, MN"
2018,Nov,9696,9192,504,5.2,"Hubbard County, MN"
2018,Dec,9872,9143,729,7.4,"Hubbard County, MN"
2019,Jan,9809,8912,897,9.1,"Hubbard County, MN"
2019,Feb,9717,8957,760,7.8,"Hubbard County, MN"
2019,Mar,9736,9006,730,7.5,"Hubbard County, MN"
2019,Apr,9691,9159,532,5.5,"Hubbard County, MN"
2019,May,10117,9696,421,4.2,"Hubbard County, MN"
2019,Jun,10479,10025,454,4.3,"Hubbard County, MN"
2019,Jul,10618,10183,435,4.1,"Hubbard County, MN"
2019,Aug,10366,9982,384,3.7,"Hubbard County, MN"
2019,Sep,10167,9828,339,3.3,"Hubbard County, MN"
2019,Oct,9985,9606,379,3.8,"Hubbard County, MN"
2019,Nov,9856,9327,529,5.4,"Hubbard County, MN"
2019,Dec,9912,9207,705,7.1,"Hubbard County, MN"
2020,Jan,9907,9077,830,8.4,"Hubbard County, MN"
2020,Feb,9827,9086,741,7.5,"Hubbard County, MN"
2020,Mar,9763,8904,859,8.8,"Hubbard County, MN"
2020,Apr,9276,8265,1011,10.9,"Hubbard County, MN"
2020,May,9735,8730,1005,10.3,"Hubbard County, MN"
2020,Jun,10521,9663,858,8.2,"Hubbard County, MN"
2020,Jul,10781,10098,683,6.3,"Hubbard County, MN"
2020,Aug,10683,10155,528,4.9,"Hubbard County, MN"
2020,Sep,10312,9836,476,4.6,"Hubbard County, MN"
2020,Oct,10193,9759,434,4.3,"Hubbard County, MN"
2020,Nov,9901,9387,514,5.2,"Hubbard County, MN"
2020,Dec,9785,9119,666,6.8,"Hubbard County, MN"
2021,Jan,10018,9311,707,7.1,"Hubbard County, MN"
2021,Feb,10028,9401,627,6.3,"Hubbard County, MN"
2021,Mar,9923,9346,577,5.8,"Hubbard County, MN"
2021,Apr,9894,9458,436,4.4,"Hubbard County, MN"
2021,May,10239,9861,378,3.7,"Hubbard County, MN"
2021,Jun,10665,10239,426,4.0,"Hubbard County, MN"
2021,Jul,11011,10661,350,3.2,"Hubbard County, MN"
2021,Aug,10807,10459,348,3.2,"Hubbard County, MN"
2021,Sep,10389,10093,296,2.8,"Hubbard County, MN"
2021,Oct,10113,9791,322,3.2,"Hubbard County, MN"
2021,Nov,9903,9549,354,3.6,"Hubbard County, MN"
2021,Dec,9927,9418,509,5.1,"Hubbard County, MN"
2022,Jan,9812,9215,597,6.1,"Hubbard County, MN"
2022,Feb,9821,9271,550,5.6,"Hubbard County, MN"
2022,Mar,9770,9259,511,5.2,"Hubbard County, MN"
2022,Apr,9738,9326,412,4.2,"Hubbard County, MN"
2022,May,10224,9898,326,3.2,"Hubbard County, MN"
2022,Jun,10579,10216,363,3.4,"Hubbard County, MN"
2022,Jul,10794,10474,320,3.0,"Hubbard County, MN"
2022,Aug,10732,10402,330,3.1,"Hubbard County, MN"
2022,Sep,10366,10103,263,2.5,"Hubbard County, MN"
2022,Oct,10126,9849,277,2.7,"Hubbard County, MN"
2022,Nov,9825,9462,363,3.7,"Hubbard County, MN"
2022,Dec,10008,9457,551,5.5,"Hubbard County, MN"
2023,Jan,9918,9279,639,6.4,"Hubbard County, MN"
2023,Feb,9913,9263,650,6.6,"Hubbard County, MN"
2023,Mar,9842,9267,575,5.8,"Hubbard County, MN"
2023,Apr,9877,9411,466,4.7,"Hubbard County, MN"
2023,May,10298,9912,386,3.7,"Hubbard County, MN"
2023,Jun,10737,10303,434,4.0,"Hubbard County, MN"
2023,Jul,10830,10441,389,3.6,"Hubbard County, MN"
2023,Aug,10775,10387,388,3.6,"Hubbard County, MN"
2023,Sep,10529,10252,277,2.6,"Hubbard County, MN"
2023,Oct,10248,9963,285,2.8,"Hubbard County, MN"
2023,Nov,10024,9697,327,3.3,"Hubbard County, MN"
2023,Dec,10046,9555,491,4.9,"Hubbard County, MN"
2024,Jan,10052,9406,646,6.4,"Hubbard County, MN"
2024,Feb,10041,9394,647,6.4,"Hubbard County, MN"
2024,Mar,10092,9502,590,5.8,"Hubbard County, MN"
2024,Apr,10101,9665,436,4.3,"Hubbard County, MN"
2024,May,10403,9993,410,3.9,"Hubbard County, MN"
2024,Jun,10703,10217,486,4.5,"Hubbard County, MN"
2024,Jul,10911,10433,478,4.4,"Hubbard County, MN"
2024,Aug,10903,10444,459,4.2,"Hubbard County, MN"
2024,Sep,10605,10263,342,3.2,"Hubbard County, MN"
2024,Oct,10362,10034,328,3.2,"Hubbard County, MN"
2024,Nov,10219(P),9750(P),469(P),4.6(P),"Hubbard County, MN"
P : Preliminary.,P : Preliminary.,P : Preliminary.,P : Preliminary.,P : Preliminary.,P : Preliminary.,"Hubbard County, MN"
2014,Jan,20223,18835,1388,6.9,"Isanti County, MN"
2014,Feb,20293,18868,1425,7.0,"Isanti County, MN"
2014,Mar,20370,18946,1424,7.0,"Isanti County, MN"
2014,Apr,20299,19141,1158,5.7,"Isanti County, MN"
2014,May,20234,19292,942,4.7,"Isanti County, MN"
2014,Jun,20357,19369,988,4.9,"Isanti County, MN"
2014,Jul,20438,19489,949,4.6,"Isanti County, MN"
2014,Aug,20237,19358,879,4.3,"Isanti County, MN"
2014,Sep,20129,19324,805,4.0,"Isanti County, MN"
2014,Oct,20182,19452,730,3.6,"Isanti County, MN"
2014,Nov,20328,19452,876,4.3,"Isanti County, MN"
2014,Dec,20350,19326,1024,5.0,"Isanti County, MN"
2015,Jan,20202,18994,1208,6.0,"Isanti County, MN"
2015,Feb,20304,19089,1215,6.0,"Isanti County, MN"
2015,Mar,20237,19083,1154,5.7,"Isanti County, MN"
2015,Apr,20186,19351,835,4.1,"Isanti County, MN"
2015,May,20306,19526,780,3.8,"Isanti County, MN"
2015,Jun,20332,19473,859,4.2,"Isanti County, MN"
2015,Jul,20436,19623,813,4.0,"Isanti County, MN"
2015,Aug,20246,19497,749,3.7,"Isanti County, MN"
2015,Sep,20063,19362,701,3.5,"Isanti County, MN"
2015,Oct,20108,19425,683,3.4,"Isanti County, MN"
2015,Nov,20181,19475,706,3.5,"Isanti County, MN"
2015,Dec,20377,19402,975,4.8,"Isanti County, MN"
2016,Jan,20614,19379,1235,6.0,"Isanti County, MN"
2016,Feb,20764,19525,1239,6.0,"Isanti County, MN"
2016,Mar,20775,19498,1277,6.1,"Isanti County, MN"
2016,Apr,20658,19699,959,4.6,"Isanti County, MN"
2016,May,20542,19768,774,3.8,"Isanti County, MN"
2016,Jun,20593,19699,894,4.3,"Isanti County, MN"
2016,Jul,20808,19963,845,4.1,"Isanti County, MN"
2016,Aug,20713,19857,856,4.1,"Isanti County, MN"
2016,Sep,20611,19817,794,3.9,"Isanti County, MN"
2016,Oct,20559,19760,799,3.9,"Isanti County, MN"
2016,Nov,20550,19758,792,3.9,"Isanti County, MN"
2016,Dec,20744,19645,1099,5.3,"Isanti County, MN"
2017,Jan,21012,19696,1316,6.3,"Isanti County, MN"
2017,Feb,21120,19846,1274,6.0,"Isanti County, MN"
2017,Mar,21208,19970,1238,5.8,"Isanti County, MN"
2017,Apr,21041,20130,911,4.3,"Isanti County, MN"
2017,May,20935,20172,763,3.6,"Isanti County, MN"
2017,Jun,21127,20286,841,4.0,"Isanti County, MN"
2017,Jul,21288,20479,809,3.8,"Isanti County, MN"
2017,Aug,21114,20332,782,3.7,"Isanti County, MN"
2017,Sep,21076,20418,658,3.1,"Isanti County, MN"
2017,Oct,20926,20292,634,3.0,"Isanti County, MN"
2017,Nov,21110,20326,784,3.7,"Isanti County, MN"
2017,Dec,21206,20201,1005,4.7,"Isanti County, MN"
2018,Jan,21374,20161,1213,5.7,"Isanti County, MN"
2018,Feb,21493,20334,1159,5.4,"Isanti County, MN"
2018,Mar,21378,20243,1135,5.3,"Isanti County, MN"
2018,Apr,21165,20292,873,4.1,"Isanti County, MN"
2018,May,21066,20435,631,3.0,"Isanti County, MN"
2018,Jun,21206,20483,723,3.4,"Isanti County, MN"
2018,Jul,21304,20647,657,3.1,"Isanti County, MN"
2018,Aug,21091,20459,632,3.0,"Isanti County, MN"
2018,Sep,21005,20456,549,2.6,"Isanti County, MN"
2018,Oct,21082,20503,579,2.7,"Isanti County, MN"
2018,Nov,21141,20542,599,2.8,"Isanti County, MN"
2018,Dec,21459,20444,1015,4.7,"Isanti County, MN"
2019,Jan,21871,20513,1358,6.2,"Isanti County, MN"
2019,Feb,21839,20625,1214,5.6,"Isanti County, MN"
2019,Mar,21763,20565,1198,5.5,"Isanti County, MN"
2019,Apr,21572,20675,897,4.2,"Isanti County, MN"
2019,May,21403,20756,647,3.0,"Isanti County, MN"
2019,Jun,21623,20878,745,3.4,"Isanti County, MN"
2019,Jul,21763,21024,739,3.4,"Isanti County, MN"
2019,Aug,21673,20961,712,3.3,"Isanti County, MN"
2019,Sep,21596,20969,627,2.9,"Isanti County, MN"
2019,Oct,21627,20977,650,3.0,"Isanti County, MN"
2019,Nov,21703,20980,723,3.3,"Isanti County, MN"
2019,Dec,22046,20946,1100,5.0,"Isanti County, MN"
2020,Jan,22565,21232,1333,5.9,"Isanti County, MN"
2020,Feb,22572,21332,1240,5.5,"Isanti County, MN"
2020,Mar,22569,21012,1557,6.9,"Isanti County, MN"
2020,Apr,21086,19074,2012,9.5,"Isanti County, MN"
2020,May,21184,18835,2349,11.1,"Isanti County, MN"
2020,Jun,21984,20081,1903,8.7,"Isanti County, MN"
2020,Jul,22170,20493,1677,7.6,"Isanti County, MN"
2020,Aug,22088,20798,1290,5.8,"Isanti County, MN"
2020,Sep,21872,20692,1180,5.4,"Isanti County, MN"
2020,Oct,21911,20869,1042,4.8,"Isanti County, MN"
2020,Nov,21919,20851,1068,4.9,"Isanti County, MN"
2020,Dec,21709,20363,1346,6.2,"Isanti County, MN"
2021,Jan,21555,20077,1478,6.9,"Isanti County, MN"
2021,Feb,21654,20167,1487,6.9,"Isanti County, MN"
2021,Mar,21540,20193,1347,6.3,"Isanti County, MN"
2021,Apr,21362,20346,1016,4.8,"Isanti County, MN"
2021,May,21271,20430,841,4.0,"Isanti County, MN"
2021,Jun,21348,20390,958,4.5,"Isanti County, MN"
2021,Jul,21422,20642,780,3.6,"Isanti County, MN"
2021,Aug,21293,20515,778,3.7,"Isanti County, MN"
2021,Sep,21143,20469,674,3.2,"Isanti County, MN"
2021,Oct,21238,20642,596,2.8,"Isanti County, MN"
2021,Nov,21387,20802,585,2.7,"Isanti County, MN"
2021,Dec,21633,20758,875,4.0,"Isanti County, MN"
2022,Jan,21744,20650,1094,5.0,"Isanti County, MN"
2022,Feb,21730,20755,975,4.5,"Isanti County, MN"
2022,Mar,21693,20798,895,4.1,"Isanti County, MN"
2022,Apr,21652,21009,643,3.0,"Isanti County, MN"
2022,May,21594,21107,487,2.3,"Isanti County, MN"
2022,Jun,21591,21009,582,2.7,"Isanti County, MN"
2022,Jul,21681,21165,516,2.4,"Isanti County, MN"
2022,Aug,21663,21094,569,2.6,"Isanti County, MN"
2022,Sep,21553,21063,490,2.3,"Isanti County, MN"
2022,Oct,21443,20941,502,2.3,"Isanti County, MN"
2022,Nov,21502,20905,597,2.8,"Isanti County, MN"
2022,Dec,21871,20882,989,4.5,"Isanti County, MN"
2023,Jan,21997,20823,1174,5.3,"Isanti County, MN"
2023,Feb,22126,20871,1255,5.7,"Isanti County, MN"
2023,Mar,22166,20976,1190,5.4,"Isanti County, MN"
2023,Apr,22002,21096,906,4.1,"Isanti County, MN"
2023,May,21852,21192,660,3.0,"Isanti County, MN"
2023,Jun,22108,21273,835,3.8,"Isanti County, MN"
2023,Jul,22069,21336,733,3.3,"Isanti County, MN"
2023,Aug,21962,21164,798,3.6,"Isanti County, MN"
2023,Sep,21704,21184,520,2.4,"Isanti County, MN"
2023,Oct,21625,21133,492,2.3,"Isanti County, MN"
2023,Nov,21667,21177,490,2.3,"Isanti County, MN"
2023,Dec,21798,20933,865,4.0,"Isanti County, MN"
2024,Jan,22054,20878,1176,5.3,"Isanti County, MN"
2024,Feb,22209,20930,1279,5.8,"Isanti County, MN"
2024,Mar,22160,21034,1126,5.1,"Isanti County, MN"
2024,Apr,21960,21120,840,3.8,"Isanti County, MN"
2024,May,21865,21015,850,3.9,"Isanti County, MN"
2024,Jun,21813,20789,1024,4.7,"Isanti County, MN"
2024,Jul,21880,20857,1023,4.7,"Isanti County, MN"
2024,Aug,21823,20758,1065,4.9,"Isanti County, MN"
2024,Sep,21561,20857,704,3.3,"Isanti County, MN"
2024,Oct,21603,20941,662,3.1,"Isanti County, MN"
2024,Nov,21675(P),20860(P),815(P),3.8(P),"Isanti County, MN"
P : Preliminary.,P : Preliminary.,P : Preliminary.,P : Preliminary.,P : Preliminary.,P : Preliminary.,"Isanti County, MN"
2014,Jan,21540,19627,1913,8.9,"Itasca County, MN"
2014,Feb,21660,19722,1938,8.9,"Itasca County, MN"
2014,Mar,21873,19994,1879,8.6,"Itasca County, MN"
2014,Apr,21743,20187,1556,7.2,"Itasca County, MN"
2014,May,22145,20691,1454,6.6,"Itasca County, MN"
2014,Jun,22537,21065,1472,6.5,"Itasca County, MN"
2014,Jul,22484,21095,1389,6.2,"Itasca County, MN"
2014,Aug,22252,20991,1261,5.7,"Itasca County, MN"
2014,Sep,22055,20895,1160,5.3,"Itasca County, MN"
2014,Oct,21959,20870,1089,5.0,"Itasca County, MN"
2014,Nov,21992,20634,1358,6.2,"Itasca County, MN"
2014,Dec,21942,20544,1398,6.4,"Itasca County, MN"
2015,Jan,21938,20347,1591,7.3,"Itasca County, MN"
2015,Feb,22043,20527,1516,6.9,"Itasca County, MN"
2015,Mar,22058,20519,1539,7.0,"Itasca County, MN"
2015,Apr,22177,20761,1416,6.4,"Itasca County, MN"
2015,May,22481,21179,1302,5.8,"Itasca County, MN"
2015,Jun,22959,21497,1462,6.4,"Itasca County, MN"
2015,Jul,22884,21497,1387,6.1,"Itasca County, MN"
2015,Aug,22784,21398,1386,6.1,"Itasca County, MN"
2015,Sep,22446,21262,1184,5.3,"Itasca County, MN"
2015,Oct,22335,21036,1299,5.8,"Itasca County, MN"
2015,Nov,22149,20412,1737,7.8,"Itasca County, MN"
2015,Dec,22157,20178,1979,8.9,"Itasca County, MN"
2016,Jan,22129,20075,2054,9.3,"Itasca County, MN"
2016,Feb,22180,20051,2129,9.6,"Itasca County, MN"
2016,Mar,22270,19926,2344,10.5,"Itasca County, MN"
2016,Apr,22026,19986,2040,9.3,"Itasca County, MN"
2016,May,22103,20378,1725,7.8,"Itasca County, MN"
2016,Jun,22638,20785,1853,8.2,"Itasca County, MN"
2016,Jul,22378,20589,1789,8.0,"Itasca County, MN"
2016,Aug,22084,20302,1782,8.1,"Itasca County, MN"
2016,Sep,21562,20083,1479,6.9,"Itasca County, MN"
2016,Oct,21652,20121,1531,7.1,"Itasca County, MN"
2016,Nov,21593,19710,1883,8.7,"Itasca County, MN"
2016,Dec,21550,19575,1975,9.2,"Itasca County, MN"
2017,Jan,21974,19814,2160,9.8,"Itasca County, MN"
2017,Feb,22007,20024,1983,9.0,"Itasca County, MN"
2017,Mar,22117,20063,2054,9.3,"Itasca County, MN"
2017,Apr,21676,19897,1779,8.2,"Itasca County, MN"
2017,May,21737,20352,1385,6.4,"Itasca County, MN"
2017,Jun,22309,20831,1478,6.6,"Itasca County, MN"
2017,Jul,22017,20653,1364,6.2,"Itasca County, MN"
2017,Aug,22008,20632,1376,6.3,"Itasca County, MN"
2017,Sep,21666,20611,1055,4.9,"Itasca County, MN"
2017,Oct,21481,20509,972,4.5,"Itasca County, MN"
2017,Nov,21630,20234,1396,6.5,"Itasca County, MN"
2017,Dec,21580,20129,1451,6.7,"Itasca County, MN"
2018,Jan,21943,20313,1630,7.4,"Itasca County, MN"
2018,Feb,21883,20312,1571,7.2,"Itasca County, MN"
2018,Mar,21962,20400,1562,7.1,"Itasca County, MN"
2018,Apr,21539,20263,1276,5.9,"Itasca County, MN"
2018,May,21838,20768,1070,4.9,"Itasca County, MN"
2018,Jun,22286,21138,1148,5.2,"Itasca County, MN"
2018,Jul,22002,20973,1029,4.7,"Itasca County, MN"
2018,Aug,21878,20869,1009,4.6,"Itasca County, MN"
2018,Sep,21543,20747,796,3.7,"Itasca County, MN"
2018,Oct,21584,20697,887,4.1,"Itasca County, MN"
2018,Nov,21658,20477,1181,5.5,"Itasca County, MN"
2018,Dec,21761,20349,1412,6.5,"Itasca County, MN"
2019,Jan,21982,20132,1850,8.4,"Itasca County, MN"
2019,Feb,21817,20258,1559,7.1,"Itasca County, MN"
2019,Mar,21869,20333,1536,7.0,"Itasca County, MN"
2019,Apr,21608,20233,1375,6.4,"Itasca County, MN"
2019,May,22139,20972,1167,5.3,"Itasca County, MN"
2019,Jun,22622,21337,1285,5.7,"Itasca County, MN"
2019,Jul,22355,21078,1277,5.7,"Itasca County, MN"
2019,Aug,22261,21093,1168,5.2,"Itasca County, MN"
2019,Sep,21950,21042,908,4.1,"Itasca County, MN"
2019,Oct,22038,21105,933,4.2,"Itasca County, MN"
2019,Nov,22024,20732,1292,5.9,"Itasca County, MN"
2019,Dec,22072,20543,1529,6.9,"Itasca County, MN"
2020,Jan,22346,20576,1770,7.9,"Itasca County, MN"
2020,Feb,22272,20632,1640,7.4,"Itasca County, MN"
2020,Mar,22416,20384,2032,9.1,"Itasca County, MN"
2020,Apr,20756,18293,2463,11.9,"Itasca County, MN"
2020,May,21808,18710,3098,14.2,"Itasca County, MN"
2020,Jun,23173,20572,2601,11.2,"Itasca County, MN"
2020,Jul,23029,20852,2177,9.5,"Itasca County, MN"
2020,Aug,22986,21337,1649,7.2,"Itasca County, MN"
2020,Sep,22281,20856,1425,6.4,"Itasca County, MN"
2020,Oct,22548,21098,1450,6.4,"Itasca County, MN"
2020,Nov,21964,20661,1303,5.9,"Itasca County, MN"
2020,Dec,21655,20184,1471,6.8,"Itasca County, MN"
2021,Jan,21689,20191,1498,6.9,"Itasca County, MN"
2021,Feb,21625,20202,1423,6.6,"Itasca County, MN"
2021,Mar,21674,20311,1363,6.3,"Itasca County, MN"
2021,Apr,21658,20324,1334,6.2,"Itasca County, MN"
2021,May,21982,20933,1049,4.8,"Itasca County, MN"
2021,Jun,22216,21116,1100,5.0,"Itasca County, MN"
2021,Jul,22025,21059,966,4.4,"Itasca County, MN"
2021,Aug,21933,21003,930,4.2,"Itasca County, MN"
2021,Sep,21527,20757,770,3.6,"Itasca County, MN"
2021,Oct,21598,20842,756,3.5,"Itasca County, MN"
2021,Nov,21563,20702,861,4.0,"Itasca County, MN"
2021,Dec,21535,20448,1087,5.0,"Itasca County, MN"
2022,Jan,21647,20325,1322,6.1,"Itasca County, MN"
2022,Feb,21562,20352,1210,5.6,"Itasca County, MN"
2022,Mar,21803,20696,1107,5.1,"Itasca County, MN"
2022,Apr,21145,20216,929,4.4,"Itasca County, MN"
2022,May,21697,20794,903,4.2,"Itasca County, MN"
2022,Jun,22001,21142,859,3.9,"Itasca County, MN"
2022,Jul,21962,21216,746,3.4,"Itasca County, MN"
2022,Aug,22007,21190,817,3.7,"Itasca County, MN"
2022,Sep,21537,20940,597,2.8,"Itasca County, MN"
2022,Oct,21492,20865,627,2.9,"Itasca County, MN"
2022,Nov,21205,20330,875,4.1,"Itasca County, MN"
2022,Dec,21494,20300,1194,5.6,"Itasca County, MN"
2023,Jan,21415,20095,1320,6.2,"Itasca County, MN"
2023,Feb,21468,20137,1331,6.2,"Itasca County, MN"
2023,Mar,21650,20371,1279,5.9,"Itasca County, MN"
2023,Apr,21552,20408,1144,5.3,"Itasca County, MN"
2023,May,21941,20958,983,4.5,"Itasca County, MN"
2023,Jun,22538,21434,1104,4.9,"Itasca County, MN"
2023,Jul,22314,21379,935,4.2,"Itasca County, MN"
2023,Aug,22187,21187,1000,4.5,"Itasca County, MN"
2023,Sep,21576,20957,619,2.9,"Itasca County, MN"
2023,Oct,21578,21004,574,2.7,"Itasca County, MN"
2023,Nov,21442,20704,738,3.4,"Itasca County, MN"
2023,Dec,21436,20456,980,4.6,"Itasca County, MN"
2024,Jan,21629,20378,1251,5.8,"Itasca County, MN"
2024,Feb,21700,20345,1355,6.2,"Itasca County, MN"
2024,Mar,21827,20598,1229,5.6,"Itasca County, MN"
2024,Apr,21565,20543,1022,4.7,"Itasca County, MN"
2024,May,21750,20790,960,4.4,"Itasca County, MN"
2024,Jun,22210,21001,1209,5.4,"Itasca County, MN"
2024,Jul,22117,20961,1156,5.2,"Itasca County, MN"
2024,Aug,22142,21032,1110,5.0,"Itasca County, MN"
2024,Sep,21677,20946,731,3.4,"Itasca County, MN"
2024,Oct,21654,20998,656,3.0,"Itasca County, MN"
2024,Nov,21599(P),20643(P),956(P),4.4(P),"Itasca County, MN"
P : Preliminary.,P : Preliminary.,P : Preliminary.,P : Preliminary.,P : Preliminary.,P : Preliminary.,"Itasca County, MN"
2014,Jan,6217,5933,284,4.6,"Jackson County, MN"
2014,Feb,6183,5916,267,4.3,"Jackson County, MN"
2014,Mar,6211,5948,263,4.2,"Jackson County, MN"
2014,Apr,6141,5928,213,3.5,"Jackson County, MN"
2014,May,6216,6013,203,3.3,"Jackson County, MN"
2014,Jun,6304,6054,250,4.0,"Jackson County, MN"
2014,Jul,6516,6148,368,5.6,"Jackson County, MN"
2014,Aug,6357,6117,240,3.8,"Jackson County, MN"
2014,Sep,6300,6026,274,4.3,"Jackson County, MN"
2014,Oct,6636,6229,407,6.1,"Jackson County, MN"
2014,Nov,6327,6115,212,3.4,"Jackson County, MN"
2014,Dec,6400,6125,275,4.3,"Jackson County, MN"
2015,Jan,6415,6134,281,4.4,"Jackson County, MN"
2015,Feb,6281,6007,274,4.4,"Jackson County, MN"
2015,Mar,6410,6152,258,4.0,"Jackson County, MN"
2015,Apr,6201,5961,240,3.9,"Jackson County, MN"
2015,May,6149,5877,272,4.4,"Jackson County, MN"
2015,Jun,6483,6148,335,5.2,"Jackson County, MN"
2015,Jul,6305,6090,215,3.4,"Jackson County, MN"
2015,Aug,6196,5989,207,3.3,"Jackson County, MN"
2015,Sep,6177,5924,253,4.1,"Jackson County, MN"
2015,Oct,6412,6208,204,3.2,"Jackson County, MN"
2015,Nov,6277,6085,192,3.1,"Jackson County, MN"
2015,Dec,6330,5942,388,6.1,"Jackson County, MN"
2016,Jan,6289,6017,272,4.3,"Jackson County, MN"
2016,Feb,6120,5846,274,4.5,"Jackson County, MN"
2016,Mar,6185,5900,285,4.6,"Jackson County, MN"
2016,Apr,6063,5852,211,3.5,"Jackson County, MN"
2016,May,5968,5639,329,5.5,"Jackson County, MN"
2016,Jun,6274,5870,404,6.4,"Jackson County, MN"
2016,Jul,6101,5742,359,5.9,"Jackson County, MN"
2016,Aug,5997,5756,241,4.0,"Jackson County, MN"
2016,Sep,5890,5662,228,3.9,"Jackson County, MN"
2016,Oct,6116,5867,249,4.1,"Jackson County, MN"
2016,Nov,6042,5854,188,3.1,"Jackson County, MN"
2016,Dec,6084,5825,259,4.3,"Jackson County, MN"
2017,Jan,5977,5694,283,4.7,"Jackson County, MN"
2017,Feb,5826,5569,257,4.4,"Jackson County, MN"
2017,Mar,5878,5628,250,4.3,"Jackson County, MN"
2017,Apr,5802,5614,188,3.2,"Jackson County, MN"
2017,May,5836,5653,183,3.1,"Jackson County, MN"
2017,Jun,5846,5648,198,3.4,"Jackson County, MN"
2017,Jul,5728,5540,188,3.3,"Jackson County, MN"
2017,Aug,5689,5414,275,4.8,"Jackson County, MN"
2017,Sep,5625,5394,231,4.1,"Jackson County, MN"
2017,Oct,5757,5597,160,2.8,"Jackson County, MN"
2017,Nov,5686,5540,146,2.6,"Jackson County, MN"
2017,Dec,5733,5547,186,3.2,"Jackson County, MN"
2018,Jan,5672,5453,219,3.9,"Jackson County, MN"
2018,Feb,5719,5516,203,3.5,"Jackson County, MN"
2018,Mar,5708,5508,200,3.5,"Jackson County, MN"
2018,Apr,5710,5555,155,2.7,"Jackson County, MN"
2018,May,5820,5701,119,2.0,"Jackson County, MN"
2018,Jun,5807,5600,207,3.6,"Jackson County, MN"
2018,Jul,5921,5700,221,3.7,"Jackson County, MN"
2018,Aug,5601,5437,164,2.9,"Jackson County, MN"
2018,Sep,5600,5478,122,2.2,"Jackson County, MN"
2018,Oct,5698,5557,141,2.5,"Jackson County, MN"
2018,Nov,5646,5523,123,2.2,"Jackson County, MN"
2018,Dec,5732,5548,184,3.2,"Jackson County, MN"
2019,Jan,5637,5381,256,4.5,"Jackson County, MN"
2019,Feb,5581,5358,223,4.0,"Jackson County, MN"
2019,Mar,5617,5400,217,3.9,"Jackson County, MN"
2019,Apr,5722,5547,175,3.1,"Jackson County, MN"
2019,May,5876,5730,146,2.5,"Jackson County, MN"
2019,Jun,5833,5558,275,4.7,"Jackson County, MN"
2019,Jul,5868,5481,387,6.6,"Jackson County, MN"
2019,Aug,5763,5593,170,2.9,"Jackson County, MN"
2019,Sep,5719,5584,135,2.4,"Jackson County, MN"
2019,Oct,5851,5730,121,2.1,"Jackson County, MN"
2019,Nov,5686,5565,121,2.1,"Jackson County, MN"
2019,Dec,5730,5555,175,3.1,"Jackson County, MN"
2020,Jan,5580,5342,238,4.3,"Jackson County, MN"
2020,Feb,5589,5362,227,4.1,"Jackson County, MN"
2020,Mar,5521,5252,269,4.9,"Jackson County, MN"
2020,Apr,5811,5398,413,7.1,"Jackson County, MN"
2020,May,5815,5285,530,9.1,"Jackson County, MN"
2020,Jun,6094,5638,456,7.5,"Jackson County, MN"
2020,Jul,6195,5805,390,6.3,"Jackson County, MN"
2020,Aug,5973,5749,224,3.8,"Jackson County, MN"
2020,Sep,5802,5603,199,3.4,"Jackson County, MN"
2020,Oct,6061,5743,318,5.2,"Jackson County, MN"
2020,Nov,5781,5587,194,3.4,"Jackson County, MN"
2020,Dec,5735,5489,246,4.3,"Jackson County, MN"
2021,Jan,5569,5270,299,5.4,"Jackson County, MN"
2021,Feb,5561,5322,239,4.3,"Jackson County, MN"
2021,Mar,5489,5249,240,4.4,"Jackson County, MN"
2021,Apr,5467,5284,183,3.3,"Jackson County, MN"
2021,May,5471,5285,186,3.4,"Jackson County, MN"
2021,Jun,5609,5339,270,4.8,"Jackson County, MN"
2021,Jul,5673,5462,211,3.7,"Jackson County, MN"
2021,Aug,5524,5366,158,2.9,"Jackson County, MN"
2021,Sep,5441,5315,126,2.3,"Jackson County, MN"
2021,Oct,5540,5426,114,2.1,"Jackson County, MN"
2021,Nov,5411,5313,98,1.8,"Jackson County, MN"
2021,Dec,5517,5388,129,2.3,"Jackson County, MN"
2022,Jan,5383,5207,176,3.3,"Jackson County, MN"
2022,Feb,5440,5291,149,2.7,"Jackson County, MN"
2022,Mar,5406,5259,147,2.7,"Jackson County, MN"
2022,Apr,5286,5186,100,1.9,"Jackson County, MN"
2022,May,5434,5271,163,3.0,"Jackson County, MN"
2022,Jun,5401,5276,125,2.3,"Jackson County, MN"
2022,Jul,5563,5388,175,3.1,"Jackson County, MN"
2022,Aug,5417,5299,118,2.2,"Jackson County, MN"
2022,Sep,5348,5258,90,1.7,"Jackson County, MN"
2022,Oct,5475,5390,85,1.6,"Jackson County, MN"
2022,Nov,5373,5281,92,1.7,"Jackson County, MN"
2022,Dec,5543,5407,136,2.5,"Jackson County, MN"
2023,Jan,5429,5275,154,2.8,"Jackson County, MN"
2023,Feb,5479,5306,173,3.2,"Jackson County, MN"
2023,Mar,5450,5280,170,3.1,"Jackson County, MN"
2023,Apr,5404,5258,146,2.7,"Jackson County, MN"
2023,May,5446,5299,147,2.7,"Jackson County, MN"
2023,Jun,5493,5280,213,3.9,"Jackson County, MN"
2023,Jul,5587,5374,213,3.8,"Jackson County, MN"
2023,Aug,5759,5561,198,3.4,"Jackson County, MN"
2023,Sep,5674,5508,166,2.9,"Jackson County, MN"
2023,Oct,5697,5579,118,2.1,"Jackson County, MN"
2023,Nov,5643,5553,90,1.6,"Jackson County, MN"
2023,Dec,5564,5436,128,2.3,"Jackson County, MN"
2024,Jan,5523,5349,174,3.2,"Jackson County, MN"
2024,Feb,5523,5335,188,3.4,"Jackson County, MN"
2024,Mar,5622,5467,155,2.8,"Jackson County, MN"
2024,Apr,5621,5495,126,2.2,"Jackson County, MN"
2024,May,5495,5363,132,2.4,"Jackson County, MN"
2024,Jun,5669,5463,206,3.6,"Jackson County, MN"
2024,Jul,5791,5556,235,4.1,"Jackson County, MN"
2024,Aug,5969,5756,213,3.6,"Jackson County, MN"
2024,Sep,5877,5715,162,2.8,"Jackson County, MN"
2024,Oct,5816,5685,131,2.3,"Jackson County, MN"
2024,Nov,5822(P),5667(P),155(P),2.7(P),"Jackson County, MN"
P : Preliminary.,P : Preliminary.,P : Preliminary.,P : Preliminary.,P : Preliminary.,P : Preliminary.,"Jackson County, MN"
2014,Jan,8940,7999,941,10.5,"Kanabec County, MN"
2014,Feb,8922,7957,965,10.8,"Kanabec County, MN"
2014,Mar,8974,7989,985,11.0,"Kanabec County, MN"
2014,Apr,8851,8067,784,8.9,"Kanabec County, MN"
2014,May,8753,8174,579,6.6,"Kanabec County, MN"
2014,Jun,8928,8352,576,6.5,"Kanabec County, MN"
2014,Jul,8980,8449,531,5.9,"Kanabec County, MN"
2014,Aug,8822,8332,490,5.6,"Kanabec County, MN"
2014,Sep,8761,8301,460,5.3,"Kanabec County, MN"
2014,Oct,8783,8357,426,4.9,"Kanabec County, MN"
2014,Nov,8854,8237,617,7.0,"Kanabec County, MN"
2014,Dec,8956,8212,744,8.3,"Kanabec County, MN"
2015,Jan,8894,8032,862,9.7,"Kanabec County, MN"
2015,Feb,8868,8006,862,9.7,"Kanabec County, MN"
2015,Mar,8970,8076,894,10.0,"Kanabec County, MN"
2015,Apr,8824,8197,627,7.1,"Kanabec County, MN"
2015,May,8822,8333,489,5.5,"Kanabec County, MN"
2015,Jun,8873,8386,487,5.5,"Kanabec County, MN"
2015,Jul,8879,8413,466,5.2,"Kanabec County, MN"
2015,Aug,8811,8357,454,5.2,"Kanabec County, MN"
2015,Sep,8647,8246,401,4.6,"Kanabec County, MN"
2015,Oct,8775,8390,385,4.4,"Kanabec County, MN"
2015,Nov,8891,8414,477,5.4,"Kanabec County, MN"
2015,Dec,9078,8337,741,8.2,"Kanabec County, MN"
2016,Jan,9231,8363,868,9.4,"Kanabec County, MN"
2016,Feb,9288,8419,869,9.4,"Kanabec County, MN"
2016,Mar,9303,8417,886,9.5,"Kanabec County, MN"
2016,Apr,9146,8484,662,7.2,"Kanabec County, MN"
2016,May,8874,8434,440,5.0,"Kanabec County, MN"
2016,Jun,8908,8455,453,5.1,"Kanabec County, MN"
2016,Jul,8799,8381,418,4.8,"Kanabec County, MN"
2016,Aug,8801,8380,421,4.8,"Kanabec County, MN"
2016,Sep,8748,8348,400,4.6,"Kanabec County, MN"
2016,Oct,8840,8457,383,4.3,"Kanabec County, MN"
2016,Nov,8889,8404,485,5.5,"Kanabec County, MN"
2016,Dec,9013,8280,733,8.1,"Kanabec County, MN"
2017,Jan,9318,8352,966,10.4,"Kanabec County, MN"
2017,Feb,9274,8383,891,9.6,"Kanabec County, MN"
2017,Mar,9302,8434,868,9.3,"Kanabec County, MN"
2017,Apr,9090,8465,625,6.9,"Kanabec County, MN"
2017,May,9016,8602,414,4.6,"Kanabec County, MN"
2017,Jun,9073,8666,407,4.5,"Kanabec County, MN"
2017,Jul,8951,8583,368,4.1,"Kanabec County, MN"
2017,Aug,8947,8565,382,4.3,"Kanabec County, MN"
2017,Sep,8846,8538,308,3.5,"Kanabec County, MN"
2017,Oct,8901,8605,296,3.3,"Kanabec County, MN"
2017,Nov,9029,8543,486,5.4,"Kanabec County, MN"
2017,Dec,9174,8486,688,7.5,"Kanabec County, MN"
2018,Jan,9128,8256,872,9.6,"Kanabec County, MN"
2018,Feb,9080,8291,789,8.7,"Kanabec County, MN"
2018,Mar,9148,8334,814,8.9,"Kanabec County, MN"
2018,Apr,9089,8467,622,6.8,"Kanabec County, MN"
2018,May,8958,8572,386,4.3,"Kanabec County, MN"
2018,Jun,9010,8633,377,4.2,"Kanabec County, MN"
2018,Jul,8877,8546,331,3.7,"Kanabec County, MN"
2018,Aug,8741,8445,296,3.4,"Kanabec County, MN"
2018,Sep,8733,8486,247,2.8,"Kanabec County, MN"
2018,Oct,8828,8573,255,2.9,"Kanabec County, MN"
2018,Nov,8839,8448,391,4.4,"Kanabec County, MN"
2018,Dec,9050,8383,667,7.4,"Kanabec County, MN"
2019,Jan,9220,8267,953,10.3,"Kanabec County, MN"
2019,Feb,9179,8342,837,9.1,"Kanabec County, MN"
2019,Mar,9165,8341,824,9.0,"Kanabec County, MN"
2019,Apr,9044,8436,608,6.7,"Kanabec County, MN"
2019,May,8979,8619,360,4.0,"Kanabec County, MN"
2019,Jun,9147,8769,378,4.1,"Kanabec County, MN"
2019,Jul,9072,8711,361,4.0,"Kanabec County, MN"
2019,Aug,9005,8701,304,3.4,"Kanabec County, MN"
2019,Sep,8947,8692,255,2.9,"Kanabec County, MN"
2019,Oct,9112,8797,315,3.5,"Kanabec County, MN"
2019,Nov,9165,8676,489,5.3,"Kanabec County, MN"
2019,Dec,9387,8581,806,8.6,"Kanabec County, MN"
2020,Jan,9497,8462,1035,10.9,"Kanabec County, MN"
2020,Feb,9386,8488,898,9.6,"Kanabec County, MN"
2020,Mar,9398,8395,1003,10.7,"Kanabec County, MN"
2020,Apr,8789,7823,966,11.0,"Kanabec County, MN"
2020,May,8800,7836,964,11.0,"Kanabec County, MN"
2020,Jun,9131,8416,715,7.8,"Kanabec County, MN"
2020,Jul,9110,8467,643,7.1,"Kanabec County, MN"
2020,Aug,9110,8617,493,5.4,"Kanabec County, MN"
2020,Sep,9160,8699,461,5.0,"Kanabec County, MN"
2020,Oct,9178,8738,440,4.8,"Kanabec County, MN"
2020,Nov,9219,8624,595,6.5,"Kanabec County, MN"
2020,Dec,9168,8420,748,8.2,"Kanabec County, MN"
2021,Jan,9137,8217,920,10.1,"Kanabec County, MN"
2021,Feb,9132,8249,883,9.7,"Kanabec County, MN"
2021,Mar,9117,8298,819,9.0,"Kanabec County, MN"
2021,Apr,9073,8479,594,6.5,"Kanabec County, MN"
2021,May,8999,8597,402,4.5,"Kanabec County, MN"
2021,Jun,9074,8660,414,4.6,"Kanabec County, MN"
2021,Jul,8815,8479,336,3.8,"Kanabec County, MN"
2021,Aug,8972,8646,326,3.6,"Kanabec County, MN"
2021,Sep,9026,8729,297,3.3,"Kanabec County, MN"
2021,Oct,9114,8827,287,3.1,"Kanabec County, MN"
2021,Nov,9116,8793,323,3.5,"Kanabec County, MN"
2021,Dec,9288,8771,517,5.6,"Kanabec County, MN"
2022,Jan,9303,8576,727,7.8,"Kanabec County, MN"
2022,Feb,9320,8659,661,7.1,"Kanabec County, MN"
2022,Mar,9295,8690,605,6.5,"Kanabec County, MN"
2022,Apr,9066,8643,423,4.7,"Kanabec County, MN"
2022,May,9113,8868,245,2.7,"Kanabec County, MN"
2022,Jun,9223,8955,268,2.9,"Kanabec County, MN"
2022,Jul,9102,8852,250,2.7,"Kanabec County, MN"
2022,Aug,9131,8855,276,3.0,"Kanabec County, MN"
2022,Sep,9128,8907,221,2.4,"Kanabec County, MN"
2022,Oct,9062,8823,239,2.6,"Kanabec County, MN"
2022,Nov,9082,8730,352,3.9,"Kanabec County, MN"
2022,Dec,9347,8687,660,7.1,"Kanabec County, MN"
2023,Jan,9436,8652,784,8.3,"Kanabec County, MN"
2023,Feb,9522,8719,803,8.4,"Kanabec County, MN"
2023,Mar,9550,8770,780,8.2,"Kanabec County, MN"
2023,Apr,9459,8881,578,6.1,"Kanabec County, MN"
2023,May,9408,9075,333,3.5,"Kanabec County, MN"
2023,Jun,9536,9131,405,4.2,"Kanabec County, MN"
2023,Jul,9295,8936,359,3.9,"Kanabec County, MN"
2023,Aug,9290,8939,351,3.8,"Kanabec County, MN"
2023,Sep,9130,8913,217,2.4,"Kanabec County, MN"
2023,Oct,9158,8928,230,2.5,"Kanabec County, MN"
2023,Nov,9171,8876,295,3.2,"Kanabec County, MN"
2023,Dec,9236,8730,506,5.5,"Kanabec County, MN"
2024,Jan,9357,8642,715,7.6,"Kanabec County, MN"
2024,Feb,9419,8668,751,8.0,"Kanabec County, MN"
2024,Mar,9436,8768,668,7.1,"Kanabec County, MN"
2024,Apr,9327,8840,487,5.2,"Kanabec County, MN"
2024,May,9320,8864,456,4.9,"Kanabec County, MN"
2024,Jun,9357,8873,484,5.2,"Kanabec County, MN"
2024,Jul,9225,8752,473,5.1,"Kanabec County, MN"
2024,Aug,9274,8843,431,4.6,"Kanabec County, MN"
2024,Sep,9193,8899,294,3.2,"Kanabec County, MN"
2024,Oct,9250,8953,297,3.2,"Kanabec County, MN"
2024,Nov,9333(P),8876(P),457(P),4.9(P),"Kanabec County, MN"
P : Preliminary.,P : Preliminary.,P : Preliminary.,P : Preliminary.,P : Preliminary.,P : Preliminary.,"Kanabec County, MN"
2014,Jan,23437,21979,1458,6.2,"Kandiyohi County, MN"
2014,Feb,23398,21938,1460,6.2,"Kandiyohi County, MN"
2014,Mar,23578,22137,1441,6.1,"Kandiyohi County, MN"
2014,Apr,23486,22370,1116,4.8,"Kandiyohi County, MN"
2014,May,23720,22823,897,3.8,"Kandiyohi County, MN"
2014,Jun,24007,23070,937,3.9,"Kandiyohi County, MN"
2014,Jul,23969,23059,910,3.8,"Kandiyohi County, MN"
2014,Aug,23778,22929,849,3.6,"Kandiyohi County, MN"
2014,Sep,23751,23008,743,3.1,"Kandiyohi County, MN"
2014,Oct,24045,23365,680,2.8,"Kandiyohi County, MN"
2014,Nov,23750,22921,829,3.5,"Kandiyohi County, MN"
2014,Dec,23805,22769,1036,4.4,"Kandiyohi County, MN"
2015,Jan,23980,22690,1290,5.4,"Kandiyohi County, MN"
2015,Feb,23720,22481,1239,5.2,"Kandiyohi County, MN"
2015,Mar,23966,22747,1219,5.1,"Kandiyohi County, MN"
2015,Apr,24037,23192,845,3.5,"Kandiyohi County, MN"
2015,May,24094,23280,814,3.4,"Kandiyohi County, MN"
2015,Jun,24619,23719,900,3.7,"Kandiyohi County, MN"
2015,Jul,24348,23510,838,3.4,"Kandiyohi County, MN"
2015,Aug,23867,23121,746,3.1,"Kandiyohi County, MN"
2015,Sep,23962,23287,675,2.8,"Kandiyohi County, MN"
2015,Oct,24365,23682,683,2.8,"Kandiyohi County, MN"
2015,Nov,24148,23399,749,3.1,"Kandiyohi County, MN"
2015,Dec,24318,23272,1046,4.3,"Kandiyohi County, MN"
2016,Jan,24256,22982,1274,5.3,"Kandiyohi County, MN"
2016,Feb,23933,22702,1231,5.1,"Kandiyohi County, MN"
2016,Mar,24281,23027,1254,5.2,"Kandiyohi County, MN"
2016,Apr,24009,23156,853,3.6,"Kandiyohi County, MN"
2016,May,24008,23271,737,3.1,"Kandiyohi County, MN"
2016,Jun,24456,23597,859,3.5,"Kandiyohi County, MN"
2016,Jul,24478,23673,805,3.3,"Kandiyohi County, MN"
2016,Aug,24030,23226,804,3.3,"Kandiyohi County, MN"
2016,Sep,23903,23199,704,2.9,"Kandiyohi County, MN"
2016,Oct,24226,23520,706,2.9,"Kandiyohi County, MN"
2016,Nov,24152,23421,731,3.0,"Kandiyohi County, MN"
2016,Dec,24356,23292,1064,4.4,"Kandiyohi County, MN"
2017,Jan,25182,23869,1313,5.2,"Kandiyohi County, MN"
2017,Feb,24823,23626,1197,4.8,"Kandiyohi County, MN"
2017,Mar,24932,23812,1120,4.5,"Kandiyohi County, MN"
2017,Apr,24879,24058,821,3.3,"Kandiyohi County, MN"
2017,May,24949,24249,700,2.8,"Kandiyohi County, MN"
2017,Jun,25264,24495,769,3.0,"Kandiyohi County, MN"
2017,Jul,24909,24234,675,2.7,"Kandiyohi County, MN"
2017,Aug,24714,24037,677,2.7,"Kandiyohi County, MN"
2017,Sep,24660,24116,544,2.2,"Kandiyohi County, MN"
2017,Oct,24949,24463,486,1.9,"Kandiyohi County, MN"
2017,Nov,24881,24255,626,2.5,"Kandiyohi County, MN"
2017,Dec,25205,24294,911,3.6,"Kandiyohi County, MN"
2018,Jan,24646,23584,1062,4.3,"Kandiyohi County, MN"
2018,Feb,24814,23773,1041,4.2,"Kandiyohi County, MN"
2018,Mar,24821,23767,1054,4.2,"Kandiyohi County, MN"
2018,Apr,24787,23988,799,3.2,"Kandiyohi County, MN"
2018,May,24905,24319,586,2.4,"Kandiyohi County, MN"
2018,Jun,25052,24350,702,2.8,"Kandiyohi County, MN"
2018,Jul,24970,24330,640,2.6,"Kandiyohi County, MN"
2018,Aug,24334,23752,582,2.4,"Kandiyohi County, MN"
2018,Sep,24509,24005,504,2.1,"Kandiyohi County, MN"
2018,Oct,24689,24196,493,2.0,"Kandiyohi County, MN"
2018,Nov,24565,24006,559,2.3,"Kandiyohi County, MN"
2018,Dec,25002,24025,977,3.9,"Kandiyohi County, MN"
2019,Jan,24242,22978,1264,5.2,"Kandiyohi County, MN"
2019,Feb,24098,22921,1177,4.9,"Kandiyohi County, MN"
2019,Mar,24234,23076,1158,4.8,"Kandiyohi County, MN"
2019,Apr,24115,23195,920,3.8,"Kandiyohi County, MN"
2019,May,24492,23786,706,2.9,"Kandiyohi County, MN"
2019,Jun,24789,23955,834,3.4,"Kandiyohi County, MN"
2019,Jul,24658,23848,810,3.3,"Kandiyohi County, MN"
2019,Aug,24335,23600,735,3.0,"Kandiyohi County, MN"
2019,Sep,24462,23843,619,2.5,"Kandiyohi County, MN"
2019,Oct,24615,24045,570,2.3,"Kandiyohi County, MN"
2019,Nov,24358,23734,624,2.6,"Kandiyohi County, MN"
2019,Dec,24811,23790,1021,4.1,"Kandiyohi County, MN"
2020,Jan,24367,23144,1223,5.0,"Kandiyohi County, MN"
2020,Feb,24299,23153,1146,4.7,"Kandiyohi County, MN"
2020,Mar,24232,22884,1348,5.6,"Kandiyohi County, MN"
2020,Apr,23929,22494,1435,6.0,"Kandiyohi County, MN"
2020,May,24158,22472,1686,7.0,"Kandiyohi County, MN"
2020,Jun,25562,24060,1502,5.9,"Kandiyohi County, MN"
2020,Jul,25580,24303,1277,5.0,"Kandiyohi County, MN"
2020,Aug,25170,24143,1027,4.1,"Kandiyohi County, MN"
2020,Sep,24991,24045,946,3.8,"Kandiyohi County, MN"
2020,Oct,25290,24397,893,3.5,"Kandiyohi County, MN"
2020,Nov,24952,24072,880,3.5,"Kandiyohi County, MN"
2020,Dec,24657,23512,1145,4.6,"Kandiyohi County, MN"
2021,Jan,23814,22494,1320,5.5,"Kandiyohi County, MN"
2021,Feb,23636,22425,1211,5.1,"Kandiyohi County, MN"
2021,Mar,23541,22328,1213,5.2,"Kandiyohi County, MN"
2021,Apr,23474,22555,919,3.9,"Kandiyohi County, MN"
2021,May,23520,22659,861,3.7,"Kandiyohi County, MN"
2021,Jun,23801,22810,991,4.2,"Kandiyohi County, MN"
2021,Jul,23846,22980,866,3.6,"Kandiyohi County, MN"
2021,Aug,23390,22586,804,3.4,"Kandiyohi County, MN"
2021,Sep,23328,22655,673,2.9,"Kandiyohi County, MN"
2021,Oct,23412,22840,572,2.4,"Kandiyohi County, MN"
2021,Nov,23217,22684,533,2.3,"Kandiyohi County, MN"
2021,Dec,23593,22770,823,3.5,"Kandiyohi County, MN"
2022,Jan,23440,22457,983,4.2,"Kandiyohi County, MN"
2022,Feb,23399,22505,894,3.8,"Kandiyohi County, MN"
2022,Mar,23478,22661,817,3.5,"Kandiyohi County, MN"
2022,Apr,23203,22618,585,2.5,"Kandiyohi County, MN"
2022,May,23136,22662,474,2.0,"Kandiyohi County, MN"
2022,Jun,23217,22607,610,2.6,"Kandiyohi County, MN"
2022,Jul,23402,22855,547,2.3,"Kandiyohi County, MN"
2022,Aug,23439,22869,570,2.4,"Kandiyohi County, MN"
2022,Sep,23251,22790,461,2.0,"Kandiyohi County, MN"
2022,Oct,23219,22816,403,1.7,"Kandiyohi County, MN"
2022,Nov,22943,22465,478,2.1,"Kandiyohi County, MN"
2022,Dec,23350,22539,811,3.5,"Kandiyohi County, MN"
2023,Jan,23098,22162,936,4.1,"Kandiyohi County, MN"
2023,Feb,23245,22281,964,4.1,"Kandiyohi County, MN"
2023,Mar,23304,22388,916,3.9,"Kandiyohi County, MN"
2023,Apr,23155,22406,749,3.2,"Kandiyohi County, MN"
2023,May,23307,22701,606,2.6,"Kandiyohi County, MN"
2023,Jun,23663,22876,787,3.3,"Kandiyohi County, MN"
2023,Jul,23515,22777,738,3.1,"Kandiyohi County, MN"
2023,Aug,23823,23098,725,3.0,"Kandiyohi County, MN"
2023,Sep,23630,23197,433,1.8,"Kandiyohi County, MN"
2023,Oct,23567,23178,389,1.7,"Kandiyohi County, MN"
2023,Nov,23438,23084,354,1.5,"Kandiyohi County, MN"
2023,Dec,23346,22743,603,2.6,"Kandiyohi County, MN"
2024,Jan,23197,22370,827,3.6,"Kandiyohi County, MN"
2024,Feb,23188,22277,911,3.9,"Kandiyohi County, MN"
2024,Mar,23460,22648,812,3.5,"Kandiyohi County, MN"
2024,Apr,23418,22814,604,2.6,"Kandiyohi County, MN"
2024,May,23186,22586,600,2.6,"Kandiyohi County, MN"
2024,Jun,23818,22866,952,4.0,"Kandiyohi County, MN"
2024,Jul,23899,22942,957,4.0,"Kandiyohi County, MN"
2024,Aug,24113,23275,838,3.5,"Kandiyohi County, MN"
2024,Sep,23935,23412,523,2.2,"Kandiyohi County, MN"
2024,Oct,23839,23281,558,2.3,"Kandiyohi County, MN"
2024,Nov,23729(P),23144(P),585(P),2.5(P),"Kandiyohi County, MN"
P : Preliminary.,P : Preliminary.,P : Preliminary.,P : Preliminary.,P : Preliminary.,P : Preliminary.,"Kandiyohi County, MN"
2014,Jan,2378,2211,167,7.0,"Kittson County, MN"
2014,Feb,2361,2196,165,7.0,"Kittson County, MN"
2014,Mar,2367,2211,156,6.6,"Kittson County, MN"
2014,Apr,2336,2215,121,5.2,"Kittson County, MN"
2014,May,2376,2278,98,4.1,"Kittson County, MN"
2014,Jun,2408,2290,118,4.9,"Kittson County, MN"
2014,Jul,2437,2315,122,5.0,"Kittson County, MN"
2014,Aug,2409,2304,105,4.4,"Kittson County, MN"
2014,Sep,2349,2263,86,3.7,"Kittson County, MN"
2014,Oct,2441,2363,78,3.2,"Kittson County, MN"
2014,Nov,2421,2330,91,3.8,"Kittson County, MN"
2014,Dec,2461,2330,131,5.3,"Kittson County, MN"
2015,Jan,2450,2313,137,5.6,"Kittson County, MN"
2015,Feb,2401,2279,122,5.1,"Kittson County, MN"
2015,Mar,2481,2356,125,5.0,"Kittson County, MN"
2015,Apr,2428,2327,101,4.2,"Kittson County, MN"
2015,May,2412,2309,103,4.3,"Kittson County, MN"
2015,Jun,2544,2412,132,5.2,"Kittson County, MN"
2015,Jul,2459,2341,118,4.8,"Kittson County, MN"
2015,Aug,2535,2350,185,7.3,"Kittson County, MN"
2015,Sep,2388,2306,82,3.4,"Kittson County, MN"
2015,Oct,2590,2508,82,3.2,"Kittson County, MN"
2015,Nov,2513,2415,98,3.9,"Kittson County, MN"
2015,Dec,2544,2426,118,4.6,"Kittson County, MN"
2016,Jan,2536,2353,183,7.2,"Kittson County, MN"
2016,Feb,2403,2264,139,5.8,"Kittson County, MN"
2016,Mar,2443,2299,144,5.9,"Kittson County, MN"
2016,Apr,2416,2306,110,4.6,"Kittson County, MN"
2016,May,2378,2297,81,3.4,"Kittson County, MN"
2016,Jun,2431,2316,115,4.7,"Kittson County, MN"
2016,Jul,2354,2243,111,4.7,"Kittson County, MN"
2016,Aug,2332,2234,98,4.2,"Kittson County, MN"
2016,Sep,2283,2216,67,2.9,"Kittson County, MN"
2016,Oct,2392,2328,64,2.7,"Kittson County, MN"
2016,Nov,2440,2355,85,3.5,"Kittson County, MN"
2016,Dec,2424,2304,120,5.0,"Kittson County, MN"
2017,Jan,2438,2301,137,5.6,"Kittson County, MN"
2017,Feb,2368,2246,122,5.2,"Kittson County, MN"
2017,Mar,2418,2299,119,4.9,"Kittson County, MN"
2017,Apr,2400,2304,96,4.0,"Kittson County, MN"
2017,May,2388,2323,65,2.7,"Kittson County, MN"
2017,Jun,2396,2299,97,4.0,"Kittson County, MN"
2017,Jul,2339,2253,86,3.7,"Kittson County, MN"
2017,Aug,2281,2207,74,3.2,"Kittson County, MN"
2017,Sep,2274,2215,59,2.6,"Kittson County, MN"
2017,Oct,2414,2368,46,1.9,"Kittson County, MN"
2017,Nov,2401,2328,73,3.0,"Kittson County, MN"
2017,Dec,2412,2315,97,4.0,"Kittson County, MN"
2018,Jan,2321,2221,100,4.3,"Kittson County, MN"
2018,Feb,2327,2234,93,4.0,"Kittson County, MN"
2018,Mar,2349,2255,94,4.0,"Kittson County, MN"
2018,Apr,2353,2278,75,3.2,"Kittson County, MN"
2018,May,2397,2339,58,2.4,"Kittson County, MN"
2018,Jun,2394,2316,78,3.3,"Kittson County, MN"
2018,Jul,2365,2293,72,3.0,"Kittson County, MN"
2018,Aug,2250,2199,51,2.3,"Kittson County, MN"
2018,Sep,2287,2245,42,1.8,"Kittson County, MN"
2018,Oct,2360,2321,39,1.7,"Kittson County, MN"
2018,Nov,2301,2250,51,2.2,"Kittson County, MN"
2018,Dec,2345,2257,88,3.8,"Kittson County, MN"
2019,Jan,2334,2210,124,5.3,"Kittson County, MN"
2019,Feb,2295,2185,110,4.8,"Kittson County, MN"
2019,Mar,2298,2197,101,4.4,"Kittson County, MN"
2019,Apr,2361,2276,85,3.6,"Kittson County, MN"
2019,May,2455,2389,66,2.7,"Kittson County, MN"
2019,Jun,2460,2368,92,3.7,"Kittson County, MN"
2019,Jul,2442,2345,97,4.0,"Kittson County, MN"
2019,Aug,2368,2286,82,3.5,"Kittson County, MN"
2019,Sep,2380,2317,63,2.6,"Kittson County, MN"
2019,Oct,2458,2396,62,2.5,"Kittson County, MN"
2019,Nov,2351,2286,65,2.8,"Kittson County, MN"
2019,Dec,2384,2281,103,4.3,"Kittson County, MN"
2020,Jan,2296,2189,107,4.7,"Kittson County, MN"
2020,Feb,2314,2202,112,4.8,"Kittson County, MN"
2020,Mar,2280,2158,122,5.4,"Kittson County, MN"
2020,Apr,2407,2257,150,6.2,"Kittson County, MN"
2020,May,2428,2240,188,7.7,"Kittson County, MN"
2020,Jun,2459,2330,129,5.2,"Kittson County, MN"
2020,Jul,2501,2388,113,4.5,"Kittson County, MN"
2020,Aug,2435,2340,95,3.9,"Kittson County, MN"
2020,Sep,2416,2338,78,3.2,"Kittson County, MN"
2020,Oct,2524,2430,94,3.7,"Kittson County, MN"
2020,Nov,2390,2310,80,3.3,"Kittson County, MN"
2020,Dec,2406,2316,90,3.7,"Kittson County, MN"
2021,Jan,2281,2183,98,4.3,"Kittson County, MN"
2021,Feb,2268,2175,93,4.1,"Kittson County, MN"
2021,Mar,2226,2135,91,4.1,"Kittson County, MN"
2021,Apr,2244,2175,69,3.1,"Kittson County, MN"
2021,May,2273,2207,66,2.9,"Kittson County, MN"
2021,Jun,2320,2240,80,3.4,"Kittson County, MN"
2021,Jul,2298,2230,68,3.0,"Kittson County, MN"
2021,Aug,2266,2209,57,2.5,"Kittson County, MN"
2021,Sep,2235,2179,56,2.5,"Kittson County, MN"
2021,Oct,2323,2278,45,1.9,"Kittson County, MN"
2021,Nov,2256,2201,55,2.4,"Kittson County, MN"
2021,Dec,2324,2247,77,3.3,"Kittson County, MN"
2022,Jan,2260,2175,85,3.8,"Kittson County, MN"
2022,Feb,2260,2186,74,3.3,"Kittson County, MN"
2022,Mar,2254,2184,70,3.1,"Kittson County, MN"
2022,Apr,2184,2129,55,2.5,"Kittson County, MN"
2022,May,2228,2179,49,2.2,"Kittson County, MN"
2022,Jun,2236,2175,61,2.7,"Kittson County, MN"
2022,Jul,2262,2207,55,2.4,"Kittson County, MN"
2022,Aug,2218,2163,55,2.5,"Kittson County, MN"
2022,Sep,2205,2162,43,2.0,"Kittson County, MN"
2022,Oct,2279,2238,41,1.8,"Kittson County, MN"
2022,Nov,2203,2149,54,2.5,"Kittson County, MN"
2022,Dec,2282,2208,74,3.2,"Kittson County, MN"
2023,Jan,2217,2132,85,3.8,"Kittson County, MN"
2023,Feb,2223,2143,80,3.6,"Kittson County, MN"
2023,Mar,2227,2149,78,3.5,"Kittson County, MN"
2023,Apr,2206,2139,67,3.0,"Kittson County, MN"
2023,May,2251,2198,53,2.4,"Kittson County, MN"
2023,Jun,2232,2151,81,3.6,"Kittson County, MN"
2023,Jul,2200,2128,72,3.3,"Kittson County, MN"
2023,Aug,2306,2228,78,3.4,"Kittson County, MN"
2023,Sep,2244,2194,50,2.2,"Kittson County, MN"
2023,Oct,2302,2256,46,2.0,"Kittson County, MN"
2023,Nov,2275,2221,54,2.4,"Kittson County, MN"
2023,Dec,2227,2158,69,3.1,"Kittson County, MN"
2024,Jan,2198,2113,85,3.9,"Kittson County, MN"
2024,Feb,2187,2101,86,3.9,"Kittson County, MN"
2024,Mar,2249,2167,82,3.6,"Kittson County, MN"
2024,Apr,2255,2184,71,3.1,"Kittson County, MN"
2024,May,2208,2143,65,2.9,"Kittson County, MN"
2024,Jun,2301,2200,101,4.4,"Kittson County, MN"
2024,Jul,2303,2204,99,4.3,"Kittson County, MN"
2024,Aug,2403,2318,85,3.5,"Kittson County, MN"
2024,Sep,2371,2315,56,2.4,"Kittson County, MN"
2024,Oct,2362,2311,51,2.2,"Kittson County, MN"
2024,Nov,2341(P),2275(P),66(P),2.8(P),"Kittson County, MN"
P : Preliminary.,P : Preliminary.,P : Preliminary.,P : Preliminary.,P : Preliminary.,P : Preliminary.,"Kittson County, MN"
2014,Jan,6439,5793,646,10.0,"Koochiching County, MN"
2014,Feb,6443,5817,626,9.7,"Koochiching County, MN"
2014,Mar,6544,5879,665,10.2,"Koochiching County, MN"
2014,Apr,6483,5834,649,10.0,"Koochiching County, MN"
2014,May,6531,5963,568,8.7,"Koochiching County, MN"
2014,Jun,6699,6123,576,8.6,"Koochiching County, MN"
2014,Jul,6468,5927,541,8.4,"Koochiching County, MN"
2014,Aug,6506,6009,497,7.6,"Koochiching County, MN"
2014,Sep,6417,5975,442,6.9,"Koochiching County, MN"
2014,Oct,6297,5866,431,6.8,"Koochiching County, MN"
2014,Nov,6289,5779,510,8.1,"Koochiching County, MN"
2014,Dec,6353,5796,557,8.8,"Koochiching County, MN"
2015,Jan,6255,5673,582,9.3,"Koochiching County, MN"
2015,Feb,6203,5664,539,8.7,"Koochiching County, MN"
2015,Mar,6267,5689,578,9.2,"Koochiching County, MN"
2015,Apr,6270,5697,573,9.1,"Koochiching County, MN"
2015,May,6314,5820,494,7.8,"Koochiching County, MN"
2015,Jun,6539,6025,514,7.9,"Koochiching County, MN"
2015,Jul,6317,5832,485,7.7,"Koochiching County, MN"
2015,Aug,6269,5827,442,7.1,"Koochiching County, MN"
2015,Sep,6211,5815,396,6.4,"Koochiching County, MN"
2015,Oct,6241,5774,467,7.5,"Koochiching County, MN"
2015,Nov,6175,5578,597,9.7,"Koochiching County, MN"
2015,Dec,6248,5663,585,9.4,"Koochiching County, MN"
2016,Jan,6219,5646,573,9.2,"Koochiching County, MN"
2016,Feb,6188,5668,520,8.4,"Koochiching County, MN"
2016,Mar,6299,5707,592,9.4,"Koochiching County, MN"
2016,Apr,6106,5496,610,10.0,"Koochiching County, MN"
2016,May,6148,5673,475,7.7,"Koochiching County, MN"
2016,Jun,6337,5813,524,8.3,"Koochiching County, MN"
2016,Jul,6165,5653,512,8.3,"Koochiching County, MN"
2016,Aug,6123,5653,470,7.7,"Koochiching County, MN"
2016,Sep,6133,5705,428,7.0,"Koochiching County, MN"
2016,Oct,6056,5603,453,7.5,"Koochiching County, MN"
2016,Nov,6072,5506,566,9.3,"Koochiching County, MN"
2016,Dec,6059,5512,547,9.0,"Koochiching County, MN"
2017,Jan,6036,5506,530,8.8,"Koochiching County, MN"
2017,Feb,6014,5542,472,7.8,"Koochiching County, MN"
2017,Mar,6071,5534,537,8.8,"Koochiching County, MN"
2017,Apr,5922,5370,552,9.3,"Koochiching County, MN"
2017,May,5974,5523,451,7.5,"Koochiching County, MN"
2017,Jun,6197,5758,439,7.1,"Koochiching County, MN"
2017,Jul,6120,5739,381,6.2,"Koochiching County, MN"
2017,Aug,5969,5577,392,6.6,"Koochiching County, MN"
2017,Sep,5975,5677,298,5.0,"Koochiching County, MN"
2017,Oct,5919,5620,299,5.1,"Koochiching County, MN"
2017,Nov,5941,5498,443,7.5,"Koochiching County, MN"
2017,Dec,5897,5522,375,6.4,"Koochiching County, MN"
2018,Jan,5825,5437,388,6.7,"Koochiching County, MN"
2018,Feb,5843,5461,382,6.5,"Koochiching County, MN"
2018,Mar,5933,5507,426,7.2,"Koochiching County, MN"
2018,Apr,5894,5456,438,7.4,"Koochiching County, MN"
2018,May,5987,5599,388,6.5,"Koochiching County, MN"
2018,Jun,6167,5769,398,6.5,"Koochiching County, MN"
2018,Jul,6092,5705,387,6.4,"Koochiching County, MN"
2018,Aug,6029,5713,316,5.2,"Koochiching County, MN"
2018,Sep,5963,5695,268,4.5,"Koochiching County, MN"
2018,Oct,5869,5545,324,5.5,"Koochiching County, MN"
2018,Nov,5856,5450,406,6.9,"Koochiching County, MN"
2018,Dec,5936,5567,369,6.2,"Koochiching County, MN"
2019,Jan,5962,5564,398,6.7,"Koochiching County, MN"
2019,Feb,5890,5551,339,5.8,"Koochiching County, MN"
2019,Mar,5919,5566,353,6.0,"Koochiching County, MN"
2019,Apr,5964,5509,455,7.6,"Koochiching County, MN"
2019,May,6134,5745,389,6.3,"Koochiching County, MN"
2019,Jun,6263,5842,421,6.7,"Koochiching County, MN"
2019,Jul,6139,5716,423,6.9,"Koochiching County, MN"
2019,Aug,6135,5762,373,6.1,"Koochiching County, MN"
2019,Sep,5986,5683,303,5.1,"Koochiching County, MN"
2019,Oct,5944,5583,361,6.1,"Koochiching County, MN"
2019,Nov,5885,5491,394,6.7,"Koochiching County, MN"
2019,Dec,5943,5540,403,6.8,"Koochiching County, MN"
2020,Jan,5837,5415,422,7.2,"Koochiching County, MN"
2020,Feb,5798,5429,369,6.4,"Koochiching County, MN"
2020,Mar,5902,5394,508,8.6,"Koochiching County, MN"
2020,Apr,5590,4979,611,10.9,"Koochiching County, MN"
2020,May,5705,5036,669,11.7,"Koochiching County, MN"
2020,Jun,6139,5603,536,8.7,"Koochiching County, MN"
2020,Jul,6047,5571,476,7.9,"Koochiching County, MN"
2020,Aug,5986,5629,357,6.0,"Koochiching County, MN"
2020,Sep,5836,5512,324,5.6,"Koochiching County, MN"
2020,Oct,5836,5545,291,5.0,"Koochiching County, MN"
2020,Nov,5772,5445,327,5.7,"Koochiching County, MN"
2020,Dec,5683,5328,355,6.2,"Koochiching County, MN"
2021,Jan,5649,5300,349,6.2,"Koochiching County, MN"
2021,Feb,5653,5347,306,5.4,"Koochiching County, MN"
2021,Mar,5602,5283,319,5.7,"Koochiching County, MN"
2021,Apr,5656,5301,355,6.3,"Koochiching County, MN"
2021,May,5752,5476,276,4.8,"Koochiching County, MN"
2021,Jun,5927,5631,296,5.0,"Koochiching County, MN"
2021,Jul,5911,5654,257,4.3,"Koochiching County, MN"
2021,Aug,5899,5660,239,4.1,"Koochiching County, MN"
2021,Sep,5749,5546,203,3.5,"Koochiching County, MN"
2021,Oct,5604,5394,210,3.7,"Koochiching County, MN"
2021,Nov,5575,5345,230,4.1,"Koochiching County, MN"
2021,Dec,5863,5634,229,3.9,"Koochiching County, MN"
2022,Jan,5750,5512,238,4.1,"Koochiching County, MN"
2022,Feb,5781,5562,219,3.8,"Koochiching County, MN"
2022,Mar,5808,5593,215,3.7,"Koochiching County, MN"
2022,Apr,5755,5476,279,4.8,"Koochiching County, MN"
2022,May,5860,5596,264,4.5,"Koochiching County, MN"
2022,Jun,5970,5724,246,4.1,"Koochiching County, MN"
2022,Jul,5955,5748,207,3.5,"Koochiching County, MN"
2022,Aug,5938,5725,213,3.6,"Koochiching County, MN"
2022,Sep,5828,5665,163,2.8,"Koochiching County, MN"
2022,Oct,5837,5657,180,3.1,"Koochiching County, MN"
2022,Nov,5752,5527,225,3.9,"Koochiching County, MN"
2022,Dec,5920,5685,235,4.0,"Koochiching County, MN"
2023,Jan,5847,5590,257,4.4,"Koochiching County, MN"
2023,Feb,5844,5602,242,4.1,"Koochiching County, MN"
2023,Mar,5843,5576,267,4.6,"Koochiching County, MN"
2023,Apr,5698,5388,310,5.4,"Koochiching County, MN"
2023,May,5742,5455,287,5.0,"Koochiching County, MN"
2023,Jun,5966,5648,318,5.3,"Koochiching County, MN"
2023,Jul,5871,5597,274,4.7,"Koochiching County, MN"
2023,Aug,5782,5529,253,4.4,"Koochiching County, MN"
2023,Sep,5738,5562,176,3.1,"Koochiching County, MN"
2023,Oct,5636,5458,178,3.2,"Koochiching County, MN"
2023,Nov,5573,5382,191,3.4,"Koochiching County, MN"
2023,Dec,5654,5438,216,3.8,"Koochiching County, MN"
2024,Jan,5635,5385,250,4.4,"Koochiching County, MN"
2024,Feb,5649,5387,262,4.6,"Koochiching County, MN"
2024,Mar,5709,5444,265,4.6,"Koochiching County, MN"
2024,Apr,5631,5353,278,4.9,"Koochiching County, MN"
2024,May,5655,5396,259,4.6,"Koochiching County, MN"
2024,Jun,5848,5547,301,5.1,"Koochiching County, MN"
2024,Jul,5803,5497,306,5.3,"Koochiching County, MN"
2024,Aug,5838,5556,282,4.8,"Koochiching County, MN"
2024,Sep,5729,5530,199,3.5,"Koochiching County, MN"
2024,Oct,5614,5419,195,3.5,"Koochiching County, MN"
2024,Nov,5596(P),5332(P),264(P),4.7(P),"Koochiching County, MN"
P : Preliminary.,P : Preliminary.,P : Preliminary.,P : Preliminary.,P : Preliminary.,P : Preliminary.,"Koochiching County, MN"
2014,Jan,3674,3384,290,7.9,"Lac qui Parle County, MN"
2014,Feb,3574,3321,253,7.1,"Lac qui Parle County, MN"
2014,Mar,3659,3414,245,6.7,"Lac qui Parle County, MN"
2014,Apr,3610,3425,185,5.1,"Lac qui Parle County, MN"
2014,May,3612,3471,141,3.9,"Lac qui Parle County, MN"
2014,Jun,3700,3541,159,4.3,"Lac qui Parle County, MN"
2014,Jul,3628,3471,157,4.3,"Lac qui Parle County, MN"
2014,Aug,3603,3462,141,3.9,"Lac qui Parle County, MN"
2014,Sep,3568,3443,125,3.5,"Lac qui Parle County, MN"
2014,Oct,3772,3652,120,3.2,"Lac qui Parle County, MN"
2014,Nov,3777,3632,145,3.8,"Lac qui Parle County, MN"
2014,Dec,3736,3562,174,4.7,"Lac qui Parle County, MN"
2015,Jan,3864,3618,246,6.4,"Lac qui Parle County, MN"
2015,Feb,3715,3509,206,5.5,"Lac qui Parle County, MN"
2015,Mar,3893,3669,224,5.8,"Lac qui Parle County, MN"
2015,Apr,3737,3596,141,3.8,"Lac qui Parle County, MN"
2015,May,3701,3560,141,3.8,"Lac qui Parle County, MN"
2015,Jun,3872,3724,148,3.8,"Lac qui Parle County, MN"
2015,Jul,3622,3485,137,3.8,"Lac qui Parle County, MN"
2015,Aug,3607,3465,142,3.9,"Lac qui Parle County, MN"
2015,Sep,3641,3525,116,3.2,"Lac qui Parle County, MN"
2015,Oct,3907,3791,116,3.0,"Lac qui Parle County, MN"
2015,Nov,3843,3732,111,2.9,"Lac qui Parle County, MN"
2015,Dec,3872,3705,167,4.3,"Lac qui Parle County, MN"
2016,Jan,3805,3583,222,5.8,"Lac qui Parle County, MN"
2016,Feb,3639,3428,211,5.8,"Lac qui Parle County, MN"
2016,Mar,3720,3529,191,5.1,"Lac qui Parle County, MN"
2016,Apr,3641,3500,141,3.9,"Lac qui Parle County, MN"
2016,May,3604,3481,123,3.4,"Lac qui Parle County, MN"
2016,Jun,3682,3533,149,4.0,"Lac qui Parle County, MN"
2016,Jul,3443,3281,162,4.7,"Lac qui Parle County, MN"
2016,Aug,3377,3244,133,3.9,"Lac qui Parle County, MN"
2016,Sep,3454,3333,121,3.5,"Lac qui Parle County, MN"
2016,Oct,3667,3555,112,3.1,"Lac qui Parle County, MN"
2016,Nov,3696,3577,119,3.2,"Lac qui Parle County, MN"
2016,Dec,3667,3495,172,4.7,"Lac qui Parle County, MN"
2017,Jan,3665,3471,194,5.3,"Lac qui Parle County, MN"
2017,Feb,3583,3408,175,4.9,"Lac qui Parle County, MN"
2017,Mar,3623,3460,163,4.5,"Lac qui Parle County, MN"
2017,Apr,3639,3513,126,3.5,"Lac qui Parle County, MN"
2017,May,3582,3476,106,3.0,"Lac qui Parle County, MN"
2017,Jun,3637,3520,117,3.2,"Lac qui Parle County, MN"
2017,Jul,3365,3263,102,3.0,"Lac qui Parle County, MN"
2017,Aug,3290,3186,104,3.2,"Lac qui Parle County, MN"
2017,Sep,3357,3272,85,2.5,"Lac qui Parle County, MN"
2017,Oct,3614,3530,84,2.3,"Lac qui Parle County, MN"
2017,Nov,3582,3495,87,2.4,"Lac qui Parle County, MN"
2017,Dec,3538,3403,135,3.8,"Lac qui Parle County, MN"
2018,Jan,3503,3311,192,5.5,"Lac qui Parle County, MN"
2018,Feb,3558,3380,178,5.0,"Lac qui Parle County, MN"
2018,Mar,3541,3369,172,4.9,"Lac qui Parle County, MN"
2018,Apr,3547,3412,135,3.8,"Lac qui Parle County, MN"
2018,May,3617,3522,95,2.6,"Lac qui Parle County, MN"
2018,Jun,3609,3476,133,3.7,"Lac qui Parle County, MN"
2018,Jul,3553,3412,141,4.0,"Lac qui Parle County, MN"
2018,Aug,3307,3185,122,3.7,"Lac qui Parle County, MN"
2018,Sep,3424,3329,95,2.8,"Lac qui Parle County, MN"
2018,Oct,3566,3480,86,2.4,"Lac qui Parle County, MN"
2018,Nov,3502,3416,86,2.5,"Lac qui Parle County, MN"
2018,Dec,3559,3416,143,4.0,"Lac qui Parle County, MN"
2019,Jan,3455,3261,194,5.6,"Lac qui Parle County, MN"
2019,Feb,3504,3304,200,5.7,"Lac qui Parle County, MN"
2019,Mar,3511,3323,188,5.4,"Lac qui Parle County, MN"
2019,Apr,3597,3444,153,4.3,"Lac qui Parle County, MN"
2019,May,3670,3555,115,3.1,"Lac qui Parle County, MN"
2019,Jun,3680,3549,131,3.6,"Lac qui Parle County, MN"
2019,Jul,3547,3416,131,3.7,"Lac qui Parle County, MN"
2019,Aug,3387,3286,101,3.0,"Lac qui Parle County, MN"
2019,Sep,3523,3440,83,2.4,"Lac qui Parle County, MN"
2019,Oct,3710,3618,92,2.5,"Lac qui Parle County, MN"
2019,Nov,3557,3462,95,2.7,"Lac qui Parle County, MN"
2019,Dec,3565,3431,134,3.8,"Lac qui Parle County, MN"
2020,Jan,3421,3221,200,5.8,"Lac qui Parle County, MN"
2020,Feb,3492,3279,213,6.1,"Lac qui Parle County, MN"
2020,Mar,3415,3199,216,6.3,"Lac qui Parle County, MN"
2020,Apr,3500,3293,207,5.9,"Lac qui Parle County, MN"
2020,May,3463,3262,201,5.8,"Lac qui Parle County, MN"
2020,Jun,3670,3481,189,5.1,"Lac qui Parle County, MN"
2020,Jul,3562,3389,173,4.9,"Lac qui Parle County, MN"
2020,Aug,3447,3313,134,3.9,"Lac qui Parle County, MN"
2020,Sep,3508,3389,119,3.4,"Lac qui Parle County, MN"
2020,Oct,3762,3637,125,3.3,"Lac qui Parle County, MN"
2020,Nov,3590,3466,124,3.5,"Lac qui Parle County, MN"
2020,Dec,3570,3422,148,4.1,"Lac qui Parle County, MN"
2021,Jan,3445,3262,183,5.3,"Lac qui Parle County, MN"
2021,Feb,3405,3235,170,5.0,"Lac qui Parle County, MN"
2021,Mar,3353,3201,152,4.5,"Lac qui Parle County, MN"
2021,Apr,3348,3246,102,3.0,"Lac qui Parle County, MN"
2021,May,3372,3291,81,2.4,"Lac qui Parle County, MN"
2021,Jun,3443,3336,107,3.1,"Lac qui Parle County, MN"
2021,Jul,3330,3242,88,2.6,"Lac qui Parle County, MN"
2021,Aug,3262,3170,92,2.8,"Lac qui Parle County, MN"
2021,Sep,3313,3245,68,2.1,"Lac qui Parle County, MN"
2021,Oct,3455,3399,56,1.6,"Lac qui Parle County, MN"
2021,Nov,3376,3318,58,1.7,"Lac qui Parle County, MN"
2021,Dec,3500,3415,85,2.4,"Lac qui Parle County, MN"
2022,Jan,3471,3339,132,3.8,"Lac qui Parle County, MN"
2022,Feb,3466,3348,118,3.4,"Lac qui Parle County, MN"
2022,Mar,3457,3338,119,3.4,"Lac qui Parle County, MN"
2022,Apr,3354,3278,76,2.3,"Lac qui Parle County, MN"
2022,May,3383,3318,65,1.9,"Lac qui Parle County, MN"
2022,Jun,3402,3313,89,2.6,"Lac qui Parle County, MN"
2022,Jul,3308,3232,76,2.3,"Lac qui Parle County, MN"
2022,Aug,3197,3122,75,2.3,"Lac qui Parle County, MN"
2022,Sep,3328,3275,53,1.6,"Lac qui Parle County, MN"
2022,Oct,3451,3392,59,1.7,"Lac qui Parle County, MN"
2022,Nov,3386,3319,67,2.0,"Lac qui Parle County, MN"
2022,Dec,3488,3374,114,3.3,"Lac qui Parle County, MN"
2023,Jan,3412,3272,140,4.1,"Lac qui Parle County, MN"
2023,Feb,3418,3289,129,3.8,"Lac qui Parle County, MN"
2023,Mar,3421,3300,121,3.5,"Lac qui Parle County, MN"
2023,Apr,3348,3256,92,2.7,"Lac qui Parle County, MN"
2023,May,3353,3276,77,2.3,"Lac qui Parle County, MN"
2023,Jun,3426,3310,116,3.4,"Lac qui Parle County, MN"
2023,Jul,3248,3139,109,3.4,"Lac qui Parle County, MN"
2023,Aug,3343,3243,100,3.0,"Lac qui Parle County, MN"
2023,Sep,3458,3399,59,1.7,"Lac qui Parle County, MN"
2023,Oct,3548,3493,55,1.6,"Lac qui Parle County, MN"
2023,Nov,3531,3479,52,1.5,"Lac qui Parle County, MN"
2023,Dec,3432,3356,76,2.2,"Lac qui Parle County, MN"
2024,Jan,3404,3284,120,3.5,"Lac qui Parle County, MN"
2024,Feb,3395,3275,120,3.5,"Lac qui Parle County, MN"
2024,Mar,3496,3388,108,3.1,"Lac qui Parle County, MN"
2024,Apr,3491,3409,82,2.3,"Lac qui Parle County, MN"
2024,May,3391,3305,86,2.5,"Lac qui Parle County, MN"
2024,Jun,3583,3434,149,4.2,"Lac qui Parle County, MN"
2024,Jul,3467,3316,151,4.4,"Lac qui Parle County, MN"
2024,Aug,3585,3460,125,3.5,"Lac qui Parle County, MN"
2024,Sep,3668,3581,87,2.4,"Lac qui Parle County, MN"
2024,Oct,3665,3587,78,2.1,"Lac qui Parle County, MN"
2024,Nov,3653(P),3572(P),81(P),2.2(P),"Lac qui Parle County, MN"
P : Preliminary.,P : Preliminary.,P : Preliminary.,P : Preliminary.,P : Preliminary.,P : Preliminary.,"Lac qui Parle County, MN"
2014,Jan,5467,5103,364,6.7,"Lake County, MN"
2014,Feb,5532,5183,349,6.3,"Lake County, MN"
2014,Mar,5558,5207,351,6.3,"Lake County, MN"
2014,Apr,5558,5265,293,5.3,"Lake County, MN"
2014,May,5711,5443,268,4.7,"Lake County, MN"
2014,Jun,5968,5708,260,4.4,"Lake County, MN"
2014,Jul,5984,5747,237,4.0,"Lake County, MN"
2014,Aug,5943,5723,220,3.7,"Lake County, MN"
2014,Sep,5781,5582,199,3.4,"Lake County, MN"
2014,Oct,5707,5510,197,3.5,"Lake County, MN"
2014,Nov,5635,5405,230,4.1,"Lake County, MN"
2014,Dec,5497,5255,242,4.4,"Lake County, MN"
2015,Jan,5462,5175,287,5.3,"Lake County, MN"
2015,Feb,5509,5225,284,5.2,"Lake County, MN"
2015,Mar,5491,5205,286,5.2,"Lake County, MN"
2015,Apr,5455,5191,264,4.8,"Lake County, MN"
2015,May,5622,5374,248,4.4,"Lake County, MN"
2015,Jun,5779,5531,248,4.3,"Lake County, MN"
2015,Jul,5942,5669,273,4.6,"Lake County, MN"
2015,Aug,5839,5610,229,3.9,"Lake County, MN"
2015,Sep,5683,5496,187,3.3,"Lake County, MN"
2015,Oct,5630,5408,222,3.9,"Lake County, MN"
2015,Nov,5461,5206,255,4.7,"Lake County, MN"
2015,Dec,5629,5104,525,9.3,"Lake County, MN"
2016,Jan,5212,4653,559,10.7,"Lake County, MN"
2016,Feb,5297,4739,558,10.5,"Lake County, MN"
2016,Mar,5317,4718,599,11.3,"Lake County, MN"
2016,Apr,5365,4984,381,7.1,"Lake County, MN"
2016,May,5361,5111,250,4.7,"Lake County, MN"
2016,Jun,5595,5331,264,4.7,"Lake County, MN"
2016,Jul,5694,5441,253,4.4,"Lake County, MN"
2016,Aug,5646,5403,243,4.3,"Lake County, MN"
2016,Sep,5497,5271,226,4.1,"Lake County, MN"
2016,Oct,5407,5166,241,4.5,"Lake County, MN"
2016,Nov,5306,5033,273,5.1,"Lake County, MN"
2016,Dec,5266,4975,291,5.5,"Lake County, MN"
2017,Jan,5365,5052,313,5.8,"Lake County, MN"
2017,Feb,5431,5141,290,5.3,"Lake County, MN"
2017,Mar,5420,5155,265,4.9,"Lake County, MN"
2017,Apr,5360,5124,236,4.4,"Lake County, MN"
2017,May,5533,5338,195,3.5,"Lake County, MN"
2017,Jun,5805,5607,198,3.4,"Lake County, MN"
2017,Jul,5830,5653,177,3.0,"Lake County, MN"
2017,Aug,5782,5609,173,3.0,"Lake County, MN"
2017,Sep,5648,5497,151,2.7,"Lake County, MN"
2017,Oct,5487,5327,160,2.9,"Lake County, MN"
2017,Nov,5356,5163,193,3.6,"Lake County, MN"
2017,Dec,5356,5125,231,4.3,"Lake County, MN"
2018,Jan,5281,5034,247,4.7,"Lake County, MN"
2018,Feb,5375,5135,240,4.5,"Lake County, MN"
2018,Mar,5326,5105,221,4.1,"Lake County, MN"
2018,Apr,5301,5136,165,3.1,"Lake County, MN"
2018,May,5453,5298,155,2.8,"Lake County, MN"
2018,Jun,5746,5575,171,3.0,"Lake County, MN"
2018,Jul,5811,5665,146,2.5,"Lake County, MN"
2018,Aug,5743,5599,144,2.5,"Lake County, MN"
2018,Sep,5586,5468,118,2.1,"Lake County, MN"
2018,Oct,5487,5356,131,2.4,"Lake County, MN"
2018,Nov,5350,5178,172,3.2,"Lake County, MN"
2018,Dec,5336,5111,225,4.2,"Lake County, MN"
2019,Jan,5379,5120,259,4.8,"Lake County, MN"
2019,Feb,5424,5186,238,4.4,"Lake County, MN"
2019,Mar,5417,5167,250,4.6,"Lake County, MN"
2019,Apr,5353,5156,197,3.7,"Lake County, MN"
2019,May,5542,5380,162,2.9,"Lake County, MN"
2019,Jun,5866,5648,218,3.7,"Lake County, MN"
2019,Jul,5831,5645,186,3.2,"Lake County, MN"
2019,Aug,5772,5598,174,3.0,"Lake County, MN"
2019,Sep,5607,5462,145,2.6,"Lake County, MN"
2019,Oct,5465,5311,154,2.8,"Lake County, MN"
2019,Nov,5336,5118,218,4.1,"Lake County, MN"
2019,Dec,5328,5107,221,4.1,"Lake County, MN"
2020,Jan,5255,4980,275,5.2,"Lake County, MN"
2020,Feb,5278,5040,238,4.5,"Lake County, MN"
2020,Mar,5272,4979,293,5.6,"Lake County, MN"
2020,Apr,5102,4577,525,10.3,"Lake County, MN"
2020,May,5140,4348,792,15.4,"Lake County, MN"
2020,Jun,5495,4844,651,11.8,"Lake County, MN"
2020,Jul,5689,5117,572,10.1,"Lake County, MN"
2020,Aug,5694,5373,321,5.6,"Lake County, MN"
2020,Sep,5517,5255,262,4.7,"Lake County, MN"
2020,Oct,5476,5258,218,4.0,"Lake County, MN"
2020,Nov,5259,5026,233,4.4,"Lake County, MN"
2020,Dec,5164,4846,318,6.2,"Lake County, MN"
2021,Jan,5213,4875,338,6.5,"Lake County, MN"
2021,Feb,5255,4971,284,5.4,"Lake County, MN"
2021,Mar,5220,4956,264,5.1,"Lake County, MN"
2021,Apr,5260,5044,216,4.1,"Lake County, MN"
2021,May,5432,5238,194,3.6,"Lake County, MN"
2021,Jun,5640,5419,221,3.9,"Lake County, MN"
2021,Jul,5651,5462,189,3.3,"Lake County, MN"
2021,Aug,5649,5463,186,3.3,"Lake County, MN"
2021,Sep,5503,5354,149,2.7,"Lake County, MN"
2021,Oct,5365,5224,141,2.6,"Lake County, MN"
2021,Nov,5260,5115,145,2.8,"Lake County, MN"
2021,Dec,5277,5118,159,3.0,"Lake County, MN"
2022,Jan,5207,5015,192,3.7,"Lake County, MN"
2022,Feb,5201,5030,171,3.3,"Lake County, MN"
2022,Mar,5217,5059,158,3.0,"Lake County, MN"
2022,Apr,5264,5135,129,2.5,"Lake County, MN"
2022,May,5525,5256,269,4.9,"Lake County, MN"
2022,Jun,5453,5116,337,6.2,"Lake County, MN"
2022,Jul,5598,5276,322,5.8,"Lake County, MN"
2022,Aug,5617,5260,357,6.4,"Lake County, MN"
2022,Sep,5458,5162,296,5.4,"Lake County, MN"
2022,Oct,5291,5037,254,4.8,"Lake County, MN"
2022,Nov,5186,4914,272,5.2,"Lake County, MN"
2022,Dec,5179,4896,283,5.5,"Lake County, MN"
2023,Jan,5080,4769,311,6.1,"Lake County, MN"
2023,Feb,5118,4809,309,6.0,"Lake County, MN"
2023,Mar,5108,4832,276,5.4,"Lake County, MN"
2023,Apr,5232,5020,212,4.1,"Lake County, MN"
2023,May,5336,5139,197,3.7,"Lake County, MN"
2023,Jun,5605,5381,224,4.0,"Lake County, MN"
2023,Jul,5559,5369,190,3.4,"Lake County, MN"
2023,Aug,5558,5377,181,3.3,"Lake County, MN"
2023,Sep,5432,5294,138,2.5,"Lake County, MN"
2023,Oct,5309,5167,142,2.7,"Lake County, MN"
2023,Nov,5151,5023,128,2.5,"Lake County, MN"
2023,Dec,5132,4970,162,3.2,"Lake County, MN"
2024,Jan,5092,4906,186,3.7,"Lake County, MN"
2024,Feb,5144,4929,215,4.2,"Lake County, MN"
2024,Mar,5126,4964,162,3.2,"Lake County, MN"
2024,Apr,5192,5053,139,2.7,"Lake County, MN"
2024,May,5308,5149,159,3.0,"Lake County, MN"
2024,Jun,5501,5308,193,3.5,"Lake County, MN"
2024,Jul,5582,5381,201,3.6,"Lake County, MN"
2024,Aug,5593,5406,187,3.3,"Lake County, MN"
2024,Sep,5465,5318,147,2.7,"Lake County, MN"
2024,Oct,5369,5235,134,2.5,"Lake County, MN"
2024,Nov,5263(P),5085(P),178(P),3.4(P),"Lake County, MN"
P : Preliminary.,P : Preliminary.,P : Preliminary.,P : Preliminary.,P : Preliminary.,P : Preliminary.,"Lake County, MN"
2014,Jan,2481,2360,121,4.9,"Lake of the Woods County, MN"
2014,Feb,2456,2336,120,4.9,"Lake of the Woods County, MN"
2014,Mar,2452,2332,120,4.9,"Lake of the Woods County, MN"
2014,Apr,2259,2138,121,5.4,"Lake of the Woods County, MN"
2014,May,2340,2230,110,4.7,"Lake of the Woods County, MN"
2014,Jun,2444,2314,130,5.3,"Lake of the Woods County, MN"
2014,Jul,2471,2340,131,5.3,"Lake of the Woods County, MN"
2014,Aug,2418,2296,122,5.0,"Lake of the Woods County, MN"
2014,Sep,2332,2228,104,4.5,"Lake of the Woods County, MN"
2014,Oct,2354,2254,100,4.2,"Lake of the Woods County, MN"
2014,Nov,2279,2158,121,5.3,"Lake of the Woods County, MN"
2014,Dec,2434,2327,107,4.4,"Lake of the Woods County, MN"
2015,Jan,2503,2395,108,4.3,"Lake of the Woods County, MN"
2015,Feb,2483,2377,106,4.3,"Lake of the Woods County, MN"
2015,Mar,2492,2388,104,4.2,"Lake of the Woods County, MN"
2015,Apr,2311,2182,129,5.6,"Lake of the Woods County, MN"
2015,May,2350,2248,102,4.3,"Lake of the Woods County, MN"
2015,Jun,2448,2336,112,4.6,"Lake of the Woods County, MN"
2015,Jul,2421,2311,110,4.5,"Lake of the Woods County, MN"
2015,Aug,2398,2290,108,4.5,"Lake of the Woods County, MN"
2015,Sep,2367,2274,93,3.9,"Lake of the Woods County, MN"
2015,Oct,2468,2375,93,3.8,"Lake of the Woods County, MN"
2015,Nov,2396,2276,120,5.0,"Lake of the Woods County, MN"
2015,Dec,2507,2358,149,5.9,"Lake of the Woods County, MN"
2016,Jan,2507,2393,114,4.5,"Lake of the Woods County, MN"
2016,Feb,2482,2367,115,4.6,"Lake of the Woods County, MN"
2016,Mar,2475,2363,112,4.5,"Lake of the Woods County, MN"
2016,Apr,2287,2164,123,5.4,"Lake of the Woods County, MN"
2016,May,2339,2246,93,4.0,"Lake of the Woods County, MN"
2016,Jun,2437,2326,111,4.6,"Lake of the Woods County, MN"
2016,Jul,2398,2277,121,5.0,"Lake of the Woods County, MN"
2016,Aug,2354,2241,113,4.8,"Lake of the Woods County, MN"
2016,Sep,2286,2195,91,4.0,"Lake of the Woods County, MN"
2016,Oct,2310,2219,91,3.9,"Lake of the Woods County, MN"
2016,Nov,2298,2151,147,6.4,"Lake of the Woods County, MN"
2016,Dec,2404,2256,148,6.2,"Lake of the Woods County, MN"
2017,Jan,2526,2394,132,5.2,"Lake of the Woods County, MN"
2017,Feb,2498,2386,112,4.5,"Lake of the Woods County, MN"
2017,Mar,2475,2368,107,4.3,"Lake of the Woods County, MN"
2017,Apr,2307,2173,134,5.8,"Lake of the Woods County, MN"
2017,May,2375,2266,109,4.6,"Lake of the Woods County, MN"
2017,Jun,2417,2304,113,4.7,"Lake of the Woods County, MN"
2017,Jul,2397,2287,110,4.6,"Lake of the Woods County, MN"
2017,Aug,2350,2230,120,5.1,"Lake of the Woods County, MN"
2017,Sep,2295,2201,94,4.1,"Lake of the Woods County, MN"
2017,Oct,2325,2244,81,3.5,"Lake of the Woods County, MN"
2017,Nov,2341,2206,135,5.8,"Lake of the Woods County, MN"
2017,Dec,2435,2322,113,4.6,"Lake of the Woods County, MN"
2018,Jan,2501,2394,107,4.3,"Lake of the Woods County, MN"
2018,Feb,2490,2396,94,3.8,"Lake of the Woods County, MN"
2018,Mar,2477,2385,92,3.7,"Lake of the Woods County, MN"
2018,Apr,2320,2210,110,4.7,"Lake of the Woods County, MN"
2018,May,2377,2293,84,3.5,"Lake of the Woods County, MN"
2018,Jun,2488,2388,100,4.0,"Lake of the Woods County, MN"
2018,Jul,2441,2337,104,4.3,"Lake of the Woods County, MN"
2018,Aug,2335,2252,83,3.6,"Lake of the Woods County, MN"
2018,Sep,2310,2248,62,2.7,"Lake of the Woods County, MN"
2018,Oct,2340,2267,73,3.1,"Lake of the Woods County, MN"
2018,Nov,2281,2172,109,4.8,"Lake of the Woods County, MN"
2018,Dec,2461,2355,106,4.3,"Lake of the Woods County, MN"
2019,Jan,2500,2398,102,4.1,"Lake of the Woods County, MN"
2019,Feb,2477,2390,87,3.5,"Lake of the Woods County, MN"
2019,Mar,2455,2363,92,3.7,"Lake of the Woods County, MN"
2019,Apr,2359,2247,112,4.7,"Lake of the Woods County, MN"
2019,May,2474,2376,98,4.0,"Lake of the Woods County, MN"
2019,Jun,2539,2422,117,4.6,"Lake of the Woods County, MN"
2019,Jul,2521,2401,120,4.8,"Lake of the Woods County, MN"
2019,Aug,2475,2360,115,4.6,"Lake of the Woods County, MN"
2019,Sep,2420,2352,68,2.8,"Lake of the Woods County, MN"
2019,Oct,2435,2343,92,3.8,"Lake of the Woods County, MN"
2019,Nov,2361,2238,123,5.2,"Lake of the Woods County, MN"
2019,Dec,2508,2386,122,4.9,"Lake of the Woods County, MN"
2020,Jan,2541,2431,110,4.3,"Lake of the Woods County, MN"
2020,Feb,2537,2433,104,4.1,"Lake of the Woods County, MN"
2020,Mar,2480,2353,127,5.1,"Lake of the Woods County, MN"
2020,Apr,2282,2021,261,11.4,"Lake of the Woods County, MN"
2020,May,2326,2102,224,9.6,"Lake of the Woods County, MN"
2020,Jun,2514,2309,205,8.2,"Lake of the Woods County, MN"
2020,Jul,2560,2385,175,6.8,"Lake of the Woods County, MN"
2020,Aug,2503,2368,135,5.4,"Lake of the Woods County, MN"
2020,Sep,2429,2318,111,4.6,"Lake of the Woods County, MN"
2020,Oct,2437,2340,97,4.0,"Lake of the Woods County, MN"
2020,Nov,2358,2211,147,6.2,"Lake of the Woods County, MN"
2020,Dec,2415,2283,132,5.5,"Lake of the Woods County, MN"
2021,Jan,2478,2367,111,4.5,"Lake of the Woods County, MN"
2021,Feb,2490,2380,110,4.4,"Lake of the Woods County, MN"
2021,Mar,2477,2364,113,4.6,"Lake of the Woods County, MN"
2021,Apr,2330,2213,117,5.0,"Lake of the Woods County, MN"
2021,May,2416,2308,108,4.5,"Lake of the Woods County, MN"
2021,Jun,2487,2383,104,4.2,"Lake of the Woods County, MN"
2021,Jul,2476,2377,99,4.0,"Lake of the Woods County, MN"
2021,Aug,2454,2363,91,3.7,"Lake of the Woods County, MN"
2021,Sep,2362,2289,73,3.1,"Lake of the Woods County, MN"
2021,Oct,2361,2298,63,2.7,"Lake of the Woods County, MN"
2021,Nov,2268,2191,77,3.4,"Lake of the Woods County, MN"
2021,Dec,2442,2367,75,3.1,"Lake of the Woods County, MN"
2022,Jan,2516,2427,89,3.5,"Lake of the Woods County, MN"
2022,Feb,2486,2419,67,2.7,"Lake of the Woods County, MN"
2022,Mar,2489,2422,67,2.7,"Lake of the Woods County, MN"
2022,Apr,2255,2193,62,2.7,"Lake of the Woods County, MN"
2022,May,2346,2279,67,2.9,"Lake of the Woods County, MN"
2022,Jun,2422,2345,77,3.2,"Lake of the Woods County, MN"
2022,Jul,2471,2392,79,3.2,"Lake of the Woods County, MN"
2022,Aug,2465,2369,96,3.9,"Lake of the Woods County, MN"
2022,Sep,2388,2320,68,2.8,"Lake of the Woods County, MN"
2022,Oct,2373,2320,53,2.2,"Lake of the Woods County, MN"
2022,Nov,2262,2192,70,3.1,"Lake of the Woods County, MN"
2022,Dec,2458,2368,90,3.7,"Lake of the Woods County, MN"
2023,Jan,2465,2383,82,3.3,"Lake of the Woods County, MN"
2023,Feb,2443,2362,81,3.3,"Lake of the Woods County, MN"
2023,Mar,2396,2309,87,3.6,"Lake of the Woods County, MN"
2023,Apr,2275,2188,87,3.8,"Lake of the Woods County, MN"
2023,May,2331,2252,79,3.4,"Lake of the Woods County, MN"
2023,Jun,2393,2307,86,3.6,"Lake of the Woods County, MN"
2023,Jul,2394,2307,87,3.6,"Lake of the Woods County, MN"
2023,Aug,2446,2353,93,3.8,"Lake of the Woods County, MN"
2023,Sep,2363,2297,66,2.8,"Lake of the Woods County, MN"
2023,Oct,2340,2275,65,2.8,"Lake of the Woods County, MN"
2023,Nov,2270,2185,85,3.7,"Lake of the Woods County, MN"
2023,Dec,2406,2306,100,4.2,"Lake of the Woods County, MN"
2024,Jan,2452,2362,90,3.7,"Lake of the Woods County, MN"
2024,Feb,2434,2343,91,3.7,"Lake of the Woods County, MN"
2024,Mar,2429,2341,88,3.6,"Lake of the Woods County, MN"
2024,Apr,2278,2188,90,4.0,"Lake of the Woods County, MN"
2024,May,2303,2219,84,3.6,"Lake of the Woods County, MN"
2024,Jun,2386,2293,93,3.9,"Lake of the Woods County, MN"
2024,Jul,2407,2307,100,4.2,"Lake of the Woods County, MN"
2024,Aug,2445,2346,99,4.0,"Lake of the Woods County, MN"
2024,Sep,2375,2303,72,3.0,"Lake of the Woods County, MN"
2024,Oct,2338,2273,65,2.8,"Lake of the Woods County, MN"
2024,Nov,2294(P),2195(P),99(P),4.3(P),"Lake of the Woods County, MN"
P : Preliminary.,P : Preliminary.,P : Preliminary.,P : Preliminary.,P : Preliminary.,P : Preliminary.,"Lake of the Woods County, MN"
2014,Jan,15574,14331,1243,8.0,"Le Sueur County, MN"
2014,Feb,15572,14343,1229,7.9,"Le Sueur County, MN"
2014,Mar,15636,14406,1230,7.9,"Le Sueur County, MN"
2014,Apr,15488,14526,962,6.2,"Le Sueur County, MN"
2014,May,15371,14640,731,4.8,"Le Sueur County, MN"
2014,Jun,15482,14721,761,4.9,"Le Sueur County, MN"
2014,Jul,15602,14897,705,4.5,"Le Sueur County, MN"
2014,Aug,15463,14814,649,4.2,"Le Sueur County, MN"
2014,Sep,15339,14740,599,3.9,"Le Sueur County, MN"
2014,Oct,15456,14909,547,3.5,"Le Sueur County, MN"
2014,Nov,15564,14880,684,4.4,"Le Sueur County, MN"
2014,Dec,15719,14794,925,5.9,"Le Sueur County, MN"
2015,Jan,15670,14568,1102,7.0,"Le Sueur County, MN"
2015,Feb,15620,14553,1067,6.8,"Le Sueur County, MN"
2015,Mar,15719,14639,1080,6.9,"Le Sueur County, MN"
2015,Apr,15552,14761,791,5.1,"Le Sueur County, MN"
2015,May,15478,14845,633,4.1,"Le Sueur County, MN"
2015,Jun,15589,14912,677,4.3,"Le Sueur County, MN"
2015,Jul,15631,14989,642,4.1,"Le Sueur County, MN"
2015,Aug,15478,14881,597,3.9,"Le Sueur County, MN"
2015,Sep,15277,14762,515,3.4,"Le Sueur County, MN"
2015,Oct,15517,14985,532,3.4,"Le Sueur County, MN"
2015,Nov,15541,14947,594,3.8,"Le Sueur County, MN"
2015,Dec,15853,14886,967,6.1,"Le Sueur County, MN"
2016,Jan,15726,14642,1084,6.9,"Le Sueur County, MN"
2016,Feb,15677,14629,1048,6.7,"Le Sueur County, MN"
2016,Mar,15747,14652,1095,7.0,"Le Sueur County, MN"
2016,Apr,15572,14769,803,5.2,"Le Sueur County, MN"
2016,May,15378,14802,576,3.7,"Le Sueur County, MN"
2016,Jun,15415,14776,639,4.1,"Le Sueur County, MN"
2016,Jul,15559,14959,600,3.9,"Le Sueur County, MN"
2016,Aug,15447,14864,583,3.8,"Le Sueur County, MN"
2016,Sep,15339,14802,537,3.5,"Le Sueur County, MN"
2016,Oct,15444,14903,541,3.5,"Le Sueur County, MN"
2016,Nov,15507,14894,613,4.0,"Le Sueur County, MN"
2016,Dec,15784,14783,1001,6.3,"Le Sueur County, MN"
2017,Jan,16096,14902,1194,7.4,"Le Sueur County, MN"
2017,Feb,16077,14923,1154,7.2,"Le Sueur County, MN"
2017,Mar,16121,15016,1105,6.9,"Le Sueur County, MN"
2017,Apr,15985,15159,826,5.2,"Le Sueur County, MN"
2017,May,15744,15180,564,3.6,"Le Sueur County, MN"
2017,Jun,15831,15241,590,3.7,"Le Sueur County, MN"
2017,Jul,15948,15383,565,3.5,"Le Sueur County, MN"
2017,Aug,15771,15218,553,3.5,"Le Sueur County, MN"
2017,Sep,15725,15265,460,2.9,"Le Sueur County, MN"
2017,Oct,15778,15335,443,2.8,"Le Sueur County, MN"
2017,Nov,15917,15307,610,3.8,"Le Sueur County, MN"
2017,Dec,16149,15210,939,5.8,"Le Sueur County, MN"
2018,Jan,16377,15199,1178,7.2,"Le Sueur County, MN"
2018,Feb,16371,15321,1050,6.4,"Le Sueur County, MN"
2018,Mar,16276,15246,1030,6.3,"Le Sueur County, MN"
2018,Apr,16137,15311,826,5.1,"Le Sueur County, MN"
2018,May,15974,15486,488,3.1,"Le Sueur County, MN"
2018,Jun,15982,15480,502,3.1,"Le Sueur County, MN"
2018,Jul,16139,15665,474,2.9,"Le Sueur County, MN"
2018,Aug,15824,15383,441,2.8,"Le Sueur County, MN"
2018,Sep,15782,15423,359,2.3,"Le Sueur County, MN"
2018,Oct,15929,15525,404,2.5,"Le Sueur County, MN"
2018,Nov,15972,15483,489,3.1,"Le Sueur County, MN"
2018,Dec,16383,15423,960,5.9,"Le Sueur County, MN"
2019,Jan,16611,15376,1235,7.4,"Le Sueur County, MN"
2019,Feb,16552,15436,1116,6.7,"Le Sueur County, MN"
2019,Mar,16496,15399,1097,6.7,"Le Sueur County, MN"
2019,Apr,16432,15570,862,5.2,"Le Sueur County, MN"
2019,May,16231,15712,519,3.2,"Le Sueur County, MN"
2019,Jun,16344,15766,578,3.5,"Le Sueur County, MN"
2019,Jul,16494,15960,534,3.2,"Le Sueur County, MN"
2019,Aug,16288,15789,499,3.1,"Le Sueur County, MN"
2019,Sep,16216,15803,413,2.5,"Le Sueur County, MN"
2019,Oct,16351,15913,438,2.7,"Le Sueur County, MN"
2019,Nov,16372,15805,567,3.5,"Le Sueur County, MN"
2019,Dec,16806,15766,1040,6.2,"Le Sueur County, MN"
2020,Jan,16712,15484,1228,7.3,"Le Sueur County, MN"
2020,Feb,16690,15563,1127,6.8,"Le Sueur County, MN"
2020,Mar,16628,15298,1330,8.0,"Le Sueur County, MN"
2020,Apr,15609,14066,1543,9.9,"Le Sueur County, MN"
2020,May,15515,13920,1595,10.3,"Le Sueur County, MN"
2020,Jun,16132,14858,1274,7.9,"Le Sueur County, MN"
2020,Jul,16359,15241,1118,6.8,"Le Sueur County, MN"
2020,Aug,16233,15368,865,5.3,"Le Sueur County, MN"
2020,Sep,16006,15246,760,4.7,"Le Sueur County, MN"
2020,Oct,16183,15519,664,4.1,"Le Sueur County, MN"
2020,Nov,16212,15398,814,5.0,"Le Sueur County, MN"
2020,Dec,16091,15037,1054,6.6,"Le Sueur County, MN"
2021,Jan,16026,14731,1295,8.1,"Le Sueur County, MN"
2021,Feb,15972,14768,1204,7.5,"Le Sueur County, MN"
2021,Mar,15817,14708,1109,7.0,"Le Sueur County, MN"
2021,Apr,15615,14837,778,5.0,"Le Sueur County, MN"
2021,May,15463,14940,523,3.4,"Le Sueur County, MN"
2021,Jun,15530,14936,594,3.8,"Le Sueur County, MN"
2021,Jul,15709,15214,495,3.2,"Le Sueur County, MN"
2021,Aug,15575,15094,481,3.1,"Le Sueur County, MN"
2021,Sep,15417,14998,419,2.7,"Le Sueur County, MN"
2021,Oct,15585,15210,375,2.4,"Le Sueur County, MN"
2021,Nov,15653,15234,419,2.7,"Le Sueur County, MN"
2021,Dec,15996,15254,742,4.6,"Le Sueur County, MN"
2022,Jan,16013,15112,901,5.6,"Le Sueur County, MN"
2022,Feb,16030,15189,841,5.2,"Le Sueur County, MN"
2022,Mar,15900,15157,743,4.7,"Le Sueur County, MN"
2022,Apr,15814,15276,538,3.4,"Le Sueur County, MN"
2022,May,15710,15368,342,2.2,"Le Sueur County, MN"
2022,Jun,15714,15292,422,2.7,"Le Sueur County, MN"
2022,Jul,15896,15529,367,2.3,"Le Sueur County, MN"
2022,Aug,15826,15428,398,2.5,"Le Sueur County, MN"
2022,Sep,15665,15361,304,1.9,"Le Sueur County, MN"
2022,Oct,15677,15375,302,1.9,"Le Sueur County, MN"
2022,Nov,15719,15272,447,2.8,"Le Sueur County, MN"
2022,Dec,16170,15301,869,5.4,"Le Sueur County, MN"
2023,Jan,16248,15234,1014,6.2,"Le Sueur County, MN"
2023,Feb,16340,15258,1082,6.6,"Le Sueur County, MN"
2023,Mar,16266,15287,979,6.0,"Le Sueur County, MN"
2023,Apr,16123,15359,764,4.7,"Le Sueur County, MN"
2023,May,15896,15429,467,2.9,"Le Sueur County, MN"
2023,Jun,15978,15443,535,3.3,"Le Sueur County, MN"
2023,Jul,16012,15554,458,2.9,"Le Sueur County, MN"
2023,Aug,16045,15549,496,3.1,"Le Sueur County, MN"
2023,Sep,15875,15543,332,2.1,"Le Sueur County, MN"
2023,Oct,15915,15572,343,2.2,"Le Sueur County, MN"
2023,Nov,15979,15579,400,2.5,"Le Sueur County, MN"
2023,Dec,16039,15333,706,4.4,"Le Sueur County, MN"
2024,Jan,16165,15258,907,5.6,"Le Sueur County, MN"
2024,Feb,16275,15275,1000,6.1,"Le Sueur County, MN"
2024,Mar,16318,15408,910,5.6,"Le Sueur County, MN"
2024,Apr,16220,15490,730,4.5,"Le Sueur County, MN"
2024,May,16044,15338,706,4.4,"Le Sueur County, MN"
2024,Jun,15991,15242,749,4.7,"Le Sueur County, MN"
2024,Jul,16023,15372,651,4.1,"Le Sueur County, MN"
2024,Aug,16110,15443,667,4.1,"Le Sueur County, MN"
2024,Sep,15923,15474,449,2.8,"Le Sueur County, MN"
2024,Oct,15940,15514,426,2.7,"Le Sueur County, MN"
2024,Nov,16017(P),15450(P),567(P),3.5(P),"Le Sueur County, MN"
P : Preliminary.,P : Preliminary.,P : Preliminary.,P : Preliminary.,P : Preliminary.,P : Preliminary.,"Le Sueur County, MN"
2014,Jan,3236,3029,207,6.4,"Lincoln County, MN"
2014,Feb,3222,3022,200,6.2,"Lincoln County, MN"
2014,Mar,3233,3023,210,6.5,"Lincoln County, MN"
2014,Apr,3211,3053,158,4.9,"Lincoln County, MN"
2014,May,3233,3109,124,3.8,"Lincoln County, MN"
2014,Jun,3264,3126,138,4.2,"Lincoln County, MN"
2014,Jul,3370,3245,125,3.7,"Lincoln County, MN"
2014,Aug,3373,3258,115,3.4,"Lincoln County, MN"
2014,Sep,3264,3164,100,3.1,"Lincoln County, MN"
2014,Oct,3354,3265,89,2.7,"Lincoln County, MN"
2014,Nov,3283,3175,108,3.3,"Lincoln County, MN"
2014,Dec,3400,3228,172,5.1,"Lincoln County, MN"
2015,Jan,3413,3214,199,5.8,"Lincoln County, MN"
2015,Feb,3284,3095,189,5.8,"Lincoln County, MN"
2015,Mar,3441,3244,197,5.7,"Lincoln County, MN"
2015,Apr,3329,3212,117,3.5,"Lincoln County, MN"
2015,May,3311,3213,98,3.0,"Lincoln County, MN"
2015,Jun,3445,3338,107,3.1,"Lincoln County, MN"
2015,Jul,3431,3336,95,2.8,"Lincoln County, MN"
2015,Aug,3342,3260,82,2.5,"Lincoln County, MN"
2015,Sep,3284,3213,71,2.2,"Lincoln County, MN"
2015,Oct,3548,3475,73,2.1,"Lincoln County, MN"
2015,Nov,3444,3353,91,2.6,"Lincoln County, MN"
2015,Dec,3516,3378,138,3.9,"Lincoln County, MN"
2016,Jan,3541,3363,178,5.0,"Lincoln County, MN"
2016,Feb,3356,3182,174,5.2,"Lincoln County, MN"
2016,Mar,3428,3251,177,5.2,"Lincoln County, MN"
2016,Apr,3379,3258,121,3.6,"Lincoln County, MN"
2016,May,3344,3249,95,2.8,"Lincoln County, MN"
2016,Jun,3371,3264,107,3.2,"Lincoln County, MN"
2016,Jul,3329,3223,106,3.2,"Lincoln County, MN"
2016,Aug,3332,3230,102,3.1,"Lincoln County, MN"
2016,Sep,3250,3156,94,2.9,"Lincoln County, MN"
2016,Oct,3434,3349,85,2.5,"Lincoln County, MN"
2016,Nov,3397,3319,78,2.3,"Lincoln County, MN"
2016,Dec,3404,3244,160,4.7,"Lincoln County, MN"
2017,Jan,3421,3229,192,5.6,"Lincoln County, MN"
2017,Feb,3317,3143,174,5.2,"Lincoln County, MN"
2017,Mar,3335,3171,164,4.9,"Lincoln County, MN"
2017,Apr,3335,3221,114,3.4,"Lincoln County, MN"
2017,May,3316,3231,85,2.6,"Lincoln County, MN"
2017,Jun,3355,3266,89,2.7,"Lincoln County, MN"
2017,Jul,3328,3248,80,2.4,"Lincoln County, MN"
2017,Aug,3293,3214,79,2.4,"Lincoln County, MN"
2017,Sep,3388,3312,76,2.2,"Lincoln County, MN"
2017,Oct,3579,3518,61,1.7,"Lincoln County, MN"
2017,Nov,3448,3376,72,2.1,"Lincoln County, MN"
2017,Dec,3356,3230,126,3.8,"Lincoln County, MN"
2018,Jan,3239,3074,165,5.1,"Lincoln County, MN"
2018,Feb,3255,3098,157,4.8,"Lincoln County, MN"
2018,Mar,3261,3102,159,4.9,"Lincoln County, MN"
2018,Apr,3245,3130,115,3.5,"Lincoln County, MN"
2018,May,3349,3269,80,2.4,"Lincoln County, MN"
2018,Jun,3342,3260,82,2.5,"Lincoln County, MN"
2018,Jul,3338,3264,74,2.2,"Lincoln County, MN"
2018,Aug,3124,3056,68,2.2,"Lincoln County, MN"
2018,Sep,3211,3150,61,1.9,"Lincoln County, MN"
2018,Oct,3328,3263,65,2.0,"Lincoln County, MN"
2018,Nov,3198,3142,56,1.8,"Lincoln County, MN"
2018,Dec,3267,3143,124,3.8,"Lincoln County, MN"
2019,Jan,3144,2974,170,5.4,"Lincoln County, MN"
2019,Feb,3127,2960,167,5.3,"Lincoln County, MN"
2019,Mar,3132,2966,166,5.3,"Lincoln County, MN"
2019,Apr,3258,3123,135,4.1,"Lincoln County, MN"
2019,May,3366,3275,91,2.7,"Lincoln County, MN"
2019,Jun,3398,3287,111,3.3,"Lincoln County, MN"
2019,Jul,3402,3289,113,3.3,"Lincoln County, MN"
2019,Aug,3218,3117,101,3.1,"Lincoln County, MN"
2019,Sep,3278,3195,83,2.5,"Lincoln County, MN"
2019,Oct,3390,3306,84,2.5,"Lincoln County, MN"
2019,Nov,3232,3127,105,3.2,"Lincoln County, MN"
2019,Dec,3293,3122,171,5.2,"Lincoln County, MN"
2020,Jan,3012,2793,219,7.3,"Lincoln County, MN"
2020,Feb,3033,2836,197,6.5,"Lincoln County, MN"
2020,Mar,3000,2782,218,7.3,"Lincoln County, MN"
2020,Apr,3063,2912,151,4.9,"Lincoln County, MN"
2020,May,3082,2926,156,5.1,"Lincoln County, MN"
2020,Jun,3266,3124,142,4.3,"Lincoln County, MN"
2020,Jul,3299,3168,131,4.0,"Lincoln County, MN"
2020,Aug,3155,3063,92,2.9,"Lincoln County, MN"
2020,Sep,3112,3033,79,2.5,"Lincoln County, MN"
2020,Oct,3351,3264,87,2.6,"Lincoln County, MN"
2020,Nov,3190,3090,100,3.1,"Lincoln County, MN"
2020,Dec,3210,3082,128,4.0,"Lincoln County, MN"
2021,Jan,3057,2868,189,6.2,"Lincoln County, MN"
2021,Feb,3024,2853,171,5.7,"Lincoln County, MN"
2021,Mar,2978,2801,177,5.9,"Lincoln County, MN"
2021,Apr,3015,2879,136,4.5,"Lincoln County, MN"
2021,May,3049,2949,100,3.3,"Lincoln County, MN"
2021,Jun,3109,3003,106,3.4,"Lincoln County, MN"
2021,Jul,3134,3040,94,3.0,"Lincoln County, MN"
2021,Aug,3031,2938,93,3.1,"Lincoln County, MN"
2021,Sep,2985,2915,70,2.3,"Lincoln County, MN"
2021,Oct,3116,3058,58,1.9,"Lincoln County, MN"
2021,Nov,2994,2937,57,1.9,"Lincoln County, MN"
2021,Dec,3163,3076,87,2.8,"Lincoln County, MN"
2022,Jan,3074,2934,140,4.6,"Lincoln County, MN"
2022,Feb,3083,2953,130,4.2,"Lincoln County, MN"
2022,Mar,3036,2909,127,4.2,"Lincoln County, MN"
2022,Apr,2963,2876,87,2.9,"Lincoln County, MN"
2022,May,3016,2965,51,1.7,"Lincoln County, MN"
2022,Jun,3010,2936,74,2.5,"Lincoln County, MN"
2022,Jul,3072,3009,63,2.1,"Lincoln County, MN"
2022,Aug,2964,2897,67,2.3,"Lincoln County, MN"
2022,Sep,2939,2891,48,1.6,"Lincoln County, MN"
2022,Oct,3065,3021,44,1.4,"Lincoln County, MN"
2022,Nov,2957,2901,56,1.9,"Lincoln County, MN"
2022,Dec,3121,3012,109,3.5,"Lincoln County, MN"
2023,Jan,3069,2908,161,5.2,"Lincoln County, MN"
2023,Feb,3079,2918,161,5.2,"Lincoln County, MN"
2023,Mar,3044,2892,152,5.0,"Lincoln County, MN"
2023,Apr,3015,2903,112,3.7,"Lincoln County, MN"
2023,May,3042,2956,86,2.8,"Lincoln County, MN"
2023,Jun,3074,2988,86,2.8,"Lincoln County, MN"
2023,Jul,3017,2942,75,2.5,"Lincoln County, MN"
2023,Aug,3108,3040,68,2.2,"Lincoln County, MN"
2023,Sep,3103,3057,46,1.5,"Lincoln County, MN"
2023,Oct,3187,3144,43,1.3,"Lincoln County, MN"
2023,Nov,3134,3092,42,1.3,"Lincoln County, MN"
2023,Dec,3095,3010,85,2.7,"Lincoln County, MN"
2024,Jan,3042,2909,133,4.4,"Lincoln County, MN"
2024,Feb,3044,2893,151,5.0,"Lincoln County, MN"
2024,Mar,3130,2995,135,4.3,"Lincoln County, MN"
2024,Apr,3146,3047,99,3.1,"Lincoln County, MN"
2024,May,3061,2972,89,2.9,"Lincoln County, MN"
2024,Jun,3188,3085,103,3.2,"Lincoln County, MN"
2024,Jul,3222,3118,104,3.2,"Lincoln County, MN"
2024,Aug,3351,3262,89,2.7,"Lincoln County, MN"
2024,Sep,3324,3258,66,2.0,"Lincoln County, MN"
2024,Oct,3317,3247,70,2.1,"Lincoln County, MN"
2024,Nov,3282(P),3206(P),76(P),2.3(P),"Lincoln County, MN"
P : Preliminary.,P : Preliminary.,P : Preliminary.,P : Preliminary.,P : Preliminary.,P : Preliminary.,"Lincoln County, MN"
2014,Jan,15220,14427,793,5.2,"Lyon County, MN"
2014,Feb,15243,14462,781,5.1,"Lyon County, MN"
2014,Mar,15344,14596,748,4.9,"Lyon County, MN"
2014,Apr,15249,14667,582,3.8,"Lyon County, MN"
2014,May,15235,14755,480,3.2,"Lyon County, MN"
2014,Jun,15208,14661,547,3.6,"Lyon County, MN"
2014,Jul,15263,14736,527,3.5,"Lyon County, MN"
2014,Aug,15240,14765,475,3.1,"Lyon County, MN"
2014,Sep,15360,14938,422,2.7,"Lyon County, MN"
2014,Oct,15638,15212,426,2.7,"Lyon County, MN"
2014,Nov,15376,14920,456,3.0,"Lyon County, MN"
2014,Dec,15411,14857,554,3.6,"Lyon County, MN"
2015,Jan,15403,14678,725,4.7,"Lyon County, MN"
2015,Feb,15272,14603,669,4.4,"Lyon County, MN"
2015,Mar,15479,14818,661,4.3,"Lyon County, MN"
2015,Apr,15316,14868,448,2.9,"Lyon County, MN"
2015,May,15331,14902,429,2.8,"Lyon County, MN"
2015,Jun,15361,14868,493,3.2,"Lyon County, MN"
2015,Jul,15158,14701,457,3.0,"Lyon County, MN"
2015,Aug,14960,14555,405,2.7,"Lyon County, MN"
2015,Sep,15061,14685,376,2.5,"Lyon County, MN"
2015,Oct,15568,15186,382,2.5,"Lyon County, MN"
2015,Nov,15433,15034,399,2.6,"Lyon County, MN"
2015,Dec,15489,14895,594,3.8,"Lyon County, MN"
2016,Jan,15293,14604,689,4.5,"Lyon County, MN"
2016,Feb,14989,14306,683,4.6,"Lyon County, MN"
2016,Mar,15157,14465,692,4.6,"Lyon County, MN"
2016,Apr,15300,14764,536,3.5,"Lyon County, MN"
2016,May,15299,14856,443,2.9,"Lyon County, MN"
2016,Jun,15320,14787,533,3.5,"Lyon County, MN"
2016,Jul,14890,14380,510,3.4,"Lyon County, MN"
2016,Aug,14809,14322,487,3.3,"Lyon County, MN"
2016,Sep,14953,14516,437,2.9,"Lyon County, MN"
2016,Oct,15499,15058,441,2.8,"Lyon County, MN"
2016,Nov,15319,14913,406,2.7,"Lyon County, MN"
2016,Dec,15291,14675,616,4.0,"Lyon County, MN"
2017,Jan,15310,14570,740,4.8,"Lyon County, MN"
2017,Feb,15251,14569,682,4.5,"Lyon County, MN"
2017,Mar,15368,14739,629,4.1,"Lyon County, MN"
2017,Apr,15281,14773,508,3.3,"Lyon County, MN"
2017,May,15129,14688,441,2.9,"Lyon County, MN"
2017,Jun,15159,14653,506,3.3,"Lyon County, MN"
2017,Jul,14665,14218,447,3.0,"Lyon County, MN"
2017,Aug,14449,13993,456,3.2,"Lyon County, MN"
2017,Sep,14733,14381,352,2.4,"Lyon County, MN"
2017,Oct,15099,14812,287,1.9,"Lyon County, MN"
2017,Nov,14957,14648,309,2.1,"Lyon County, MN"
2017,Dec,14998,14540,458,3.1,"Lyon County, MN"
2018,Jan,14665,14068,597,4.1,"Lyon County, MN"
2018,Feb,14852,14280,572,3.9,"Lyon County, MN"
2018,Mar,14909,14354,555,3.7,"Lyon County, MN"
2018,Apr,14943,14486,457,3.1,"Lyon County, MN"
2018,May,15099,14720,379,2.5,"Lyon County, MN"
2018,Jun,15013,14556,457,3.0,"Lyon County, MN"
2018,Jul,14607,14185,422,2.9,"Lyon County, MN"
2018,Aug,14228,13837,391,2.7,"Lyon County, MN"
2018,Sep,14734,14425,309,2.1,"Lyon County, MN"
2018,Oct,14834,14521,313,2.1,"Lyon County, MN"
2018,Nov,14710,14423,287,2.0,"Lyon County, MN"
2018,Dec,14692,14234,458,3.1,"Lyon County, MN"
2019,Jan,14525,13900,625,4.3,"Lyon County, MN"
2019,Feb,14476,13898,578,4.0,"Lyon County, MN"
2019,Mar,14574,13996,578,4.0,"Lyon County, MN"
2019,Apr,14685,14196,489,3.3,"Lyon County, MN"
2019,May,14921,14518,403,2.7,"Lyon County, MN"
2019,Jun,14905,14394,511,3.4,"Lyon County, MN"
2019,Jul,14538,14048,490,3.4,"Lyon County, MN"
2019,Aug,14120,13689,431,3.1,"Lyon County, MN"
2019,Sep,14597,14243,354,2.4,"Lyon County, MN"
2019,Oct,14711,14390,321,2.2,"Lyon County, MN"
2019,Nov,14435,14086,349,2.4,"Lyon County, MN"
2019,Dec,14572,14055,517,3.5,"Lyon County, MN"
2020,Jan,14371,13725,646,4.5,"Lyon County, MN"
2020,Feb,14416,13850,566,3.9,"Lyon County, MN"
2020,Mar,14409,13683,726,5.0,"Lyon County, MN"
2020,Apr,14510,13711,799,5.5,"Lyon County, MN"
2020,May,14640,13743,897,6.1,"Lyon County, MN"
2020,Jun,15217,14362,855,5.6,"Lyon County, MN"
2020,Jul,14737,13977,760,5.2,"Lyon County, MN"
2020,Aug,14548,13950,598,4.1,"Lyon County, MN"
2020,Sep,14491,13960,531,3.7,"Lyon County, MN"
2020,Oct,15120,14652,468,3.1,"Lyon County, MN"
2020,Nov,14725,14247,478,3.2,"Lyon County, MN"
2020,Dec,14737,14186,551,3.7,"Lyon County, MN"
2021,Jan,14307,13671,636,4.4,"Lyon County, MN"
2021,Feb,14388,13799,589,4.1,"Lyon County, MN"
2021,Mar,14452,13880,572,4.0,"Lyon County, MN"
2021,Apr,14338,13898,440,3.1,"Lyon County, MN"
2021,May,14436,14061,375,2.6,"Lyon County, MN"
2021,Jun,14503,14024,479,3.3,"Lyon County, MN"
2021,Jul,14089,13725,364,2.6,"Lyon County, MN"
2021,Aug,13943,13565,378,2.7,"Lyon County, MN"
2021,Sep,14144,13838,306,2.2,"Lyon County, MN"
2021,Oct,14497,14220,277,1.9,"Lyon County, MN"
2021,Nov,14324,14058,266,1.9,"Lyon County, MN"
2021,Dec,14656,14294,362,2.5,"Lyon County, MN"
2022,Jan,14552,14065,487,3.3,"Lyon County, MN"
2022,Feb,14637,14180,457,3.1,"Lyon County, MN"
2022,Mar,14618,14186,432,3.0,"Lyon County, MN"
2022,Apr,14467,14167,300,2.1,"Lyon County, MN"
2022,May,14440,14167,273,1.9,"Lyon County, MN"
2022,Jun,14452,14093,359,2.5,"Lyon County, MN"
2022,Jul,14076,13749,327,2.3,"Lyon County, MN"
2022,Aug,13973,13641,332,2.4,"Lyon County, MN"
2022,Sep,14232,13985,247,1.7,"Lyon County, MN"
2022,Oct,14386,14152,234,1.6,"Lyon County, MN"
2022,Nov,14170,13912,258,1.8,"Lyon County, MN"
2022,Dec,14490,14096,394,2.7,"Lyon County, MN"
2023,Jan,14207,13746,461,3.2,"Lyon County, MN"
2023,Feb,14378,13876,502,3.5,"Lyon County, MN"
2023,Mar,14365,13906,459,3.2,"Lyon County, MN"
2023,Apr,14233,13861,372,2.6,"Lyon County, MN"
2023,May,14211,13906,305,2.1,"Lyon County, MN"
2023,Jun,14433,13983,450,3.1,"Lyon County, MN"
2023,Jul,13849,13448,401,2.9,"Lyon County, MN"
2023,Aug,14140,13713,427,3.0,"Lyon County, MN"
2023,Sep,14308,14064,244,1.7,"Lyon County, MN"
2023,Oct,14447,14226,221,1.5,"Lyon County, MN"
2023,Nov,14344,14144,200,1.4,"Lyon County, MN"
2023,Dec,14151,13832,319,2.3,"Lyon County, MN"
2024,Jan,14070,13632,438,3.1,"Lyon County, MN"
2024,Feb,14146,13665,481,3.4,"Lyon County, MN"
2024,Mar,14362,13948,414,2.9,"Lyon County, MN"
2024,Apr,14361,14030,331,2.3,"Lyon County, MN"
2024,May,14125,13780,345,2.4,"Lyon County, MN"
2024,Jun,14492,13930,562,3.9,"Lyon County, MN"
2024,Jul,14151,13599,552,3.9,"Lyon County, MN"
2024,Aug,14460,13930,530,3.7,"Lyon County, MN"
2024,Sep,14559,14256,303,2.1,"Lyon County, MN"
2024,Oct,14598,14337,261,1.8,"Lyon County, MN"
2024,Nov,14550(P),14240(P),310(P),2.1(P),"Lyon County, MN"
P : Preliminary.,P : Preliminary.,P : Preliminary.,P : Preliminary.,P : Preliminary.,P : Preliminary.,"Lyon County, MN"
2014,Jan,19409,18155,1254,6.5,"McLeod County, MN"
2014,Feb,19392,18153,1239,6.4,"McLeod County, MN"
2014,Mar,19581,18293,1288,6.6,"McLeod County, MN"
2014,Apr,19513,18504,1009,5.2,"McLeod County, MN"
2014,May,19545,18668,877,4.5,"McLeod County, MN"
2014,Jun,20128,19187,941,4.7,"McLeod County, MN"
2014,Jul,20218,19339,879,4.3,"McLeod County, MN"
2014,Aug,20313,19490,823,4.1,"McLeod County, MN"
2014,Sep,20161,19442,719,3.6,"McLeod County, MN"
2014,Oct,20279,19622,657,3.2,"McLeod County, MN"
2014,Nov,19916,19201,715,3.6,"McLeod County, MN"
2014,Dec,19976,19110,866,4.3,"McLeod County, MN"
2015,Jan,20101,19041,1060,5.3,"McLeod County, MN"
2015,Feb,19967,18954,1013,5.1,"McLeod County, MN"
2015,Mar,20108,19101,1007,5.0,"McLeod County, MN"
2015,Apr,20008,19236,772,3.9,"McLeod County, MN"
2015,May,20088,19326,762,3.8,"McLeod County, MN"
2015,Jun,20656,19805,851,4.1,"McLeod County, MN"
2015,Jul,20529,19755,774,3.8,"McLeod County, MN"
2015,Aug,20581,19872,709,3.4,"McLeod County, MN"
2015,Sep,20361,19718,643,3.2,"McLeod County, MN"
2015,Oct,20314,19680,634,3.1,"McLeod County, MN"
2015,Nov,20116,19459,657,3.3,"McLeod County, MN"
2015,Dec,20184,19308,876,4.3,"McLeod County, MN"
2016,Jan,19973,18938,1035,5.2,"McLeod County, MN"
2016,Feb,19847,18833,1014,5.1,"McLeod County, MN"
2016,Mar,19975,18922,1053,5.3,"McLeod County, MN"
2016,Apr,19835,19037,798,4.0,"McLeod County, MN"
2016,May,19720,18942,778,3.9,"McLeod County, MN"
2016,Jun,19957,19034,923,4.6,"McLeod County, MN"
2016,Jul,19803,18947,856,4.3,"McLeod County, MN"
2016,Aug,19655,18822,833,4.2,"McLeod County, MN"
2016,Sep,19514,18772,742,3.8,"McLeod County, MN"
2016,Oct,19643,18892,751,3.8,"McLeod County, MN"
2016,Nov,19577,18870,707,3.6,"McLeod County, MN"
2016,Dec,19674,18702,972,4.9,"McLeod County, MN"
2017,Jan,19749,18628,1121,5.7,"McLeod County, MN"
2017,Feb,19710,18633,1077,5.5,"McLeod County, MN"
2017,Mar,19832,18831,1001,5.0,"McLeod County, MN"
2017,Apr,19647,18893,754,3.8,"McLeod County, MN"
2017,May,19587,18934,653,3.3,"McLeod County, MN"
2017,Jun,19742,19010,732,3.7,"McLeod County, MN"
2017,Jul,19707,19025,682,3.5,"McLeod County, MN"
2017,Aug,19502,18852,650,3.3,"McLeod County, MN"
2017,Sep,19336,18788,548,2.8,"McLeod County, MN"
2017,Oct,19442,18944,498,2.6,"McLeod County, MN"
2017,Nov,19400,18856,544,2.8,"McLeod County, MN"
2017,Dec,19473,18736,737,3.8,"McLeod County, MN"
2018,Jan,19542,18681,861,4.4,"McLeod County, MN"
2018,Feb,19628,18767,861,4.4,"McLeod County, MN"
2018,Mar,19619,18764,855,4.4,"McLeod County, MN"
2018,Apr,19606,18929,677,3.5,"McLeod County, MN"
2018,May,19673,19160,513,2.6,"McLeod County, MN"
2018,Jun,19877,19247,630,3.2,"McLeod County, MN"
2018,Jul,19725,19203,522,2.6,"McLeod County, MN"
2018,Aug,19377,18883,494,2.5,"McLeod County, MN"
2018,Sep,19302,18869,433,2.2,"McLeod County, MN"
2018,Oct,19323,18886,437,2.3,"McLeod County, MN"
2018,Nov,19329,18856,473,2.4,"McLeod County, MN"
2018,Dec,19527,18732,795,4.1,"McLeod County, MN"
2019,Jan,19448,18449,999,5.1,"McLeod County, MN"
2019,Feb,19371,18437,934,4.8,"McLeod County, MN"
2019,Mar,19348,18415,933,4.8,"McLeod County, MN"
2019,Apr,19320,18599,721,3.7,"McLeod County, MN"
2019,May,19450,18864,586,3.0,"McLeod County, MN"
2019,Jun,19670,18950,720,3.7,"McLeod County, MN"
2019,Jul,19546,18858,688,3.5,"McLeod County, MN"
2019,Aug,19419,18748,671,3.5,"McLeod County, MN"
2019,Sep,19320,18770,550,2.8,"McLeod County, MN"
2019,Oct,19443,18915,528,2.7,"McLeod County, MN"
2019,Nov,19300,18731,569,2.9,"McLeod County, MN"
2019,Dec,19507,18676,831,4.3,"McLeod County, MN"
2020,Jan,19490,18467,1023,5.2,"McLeod County, MN"
2020,Feb,19375,18423,952,4.9,"McLeod County, MN"
2020,Mar,19279,18161,1118,5.8,"McLeod County, MN"
2020,Apr,18889,17502,1387,7.3,"McLeod County, MN"
2020,May,18815,17156,1659,8.8,"McLeod County, MN"
2020,Jun,19667,18222,1445,7.3,"McLeod County, MN"
2020,Jul,19831,18535,1296,6.5,"McLeod County, MN"
2020,Aug,19653,18632,1021,5.2,"McLeod County, MN"
2020,Sep,19408,18514,894,4.6,"McLeod County, MN"
2020,Oct,19724,18883,841,4.3,"McLeod County, MN"
2020,Nov,19449,18643,806,4.1,"McLeod County, MN"
2020,Dec,19426,18411,1015,5.2,"McLeod County, MN"
2021,Jan,19335,18233,1102,5.7,"McLeod County, MN"
2021,Feb,19262,18237,1025,5.3,"McLeod County, MN"
2021,Mar,19225,18245,980,5.1,"McLeod County, MN"
2021,Apr,19156,18423,733,3.8,"McLeod County, MN"
2021,May,19208,18580,628,3.3,"McLeod County, MN"
2021,Jun,19312,18560,752,3.9,"McLeod County, MN"
2021,Jul,19173,18542,631,3.3,"McLeod County, MN"
2021,Aug,19102,18475,627,3.3,"McLeod County, MN"
2021,Sep,18919,18387,532,2.8,"McLeod County, MN"
2021,Oct,19019,18582,437,2.3,"McLeod County, MN"
2021,Nov,19050,18612,438,2.3,"McLeod County, MN"
2021,Dec,19339,18716,623,3.2,"McLeod County, MN"
2022,Jan,19321,18522,799,4.1,"McLeod County, MN"
2022,Feb,19268,18581,687,3.6,"McLeod County, MN"
2022,Mar,19337,18687,650,3.4,"McLeod County, MN"
2022,Apr,19245,18782,463,2.4,"McLeod County, MN"
2022,May,19344,18955,389,2.0,"McLeod County, MN"
2022,Jun,19471,18956,515,2.6,"McLeod County, MN"
2022,Jul,19402,18954,448,2.3,"McLeod County, MN"
2022,Aug,19344,18855,489,2.5,"McLeod County, MN"
2022,Sep,19124,18734,390,2.0,"McLeod County, MN"
2022,Oct,19108,18725,383,2.0,"McLeod County, MN"
2022,Nov,18967,18532,435,2.3,"McLeod County, MN"
2022,Dec,19354,18657,697,3.6,"McLeod County, MN"
2023,Jan,19416,18615,801,4.1,"McLeod County, MN"
2023,Feb,19459,18613,846,4.3,"McLeod County, MN"
2023,Mar,19459,18613,846,4.3,"McLeod County, MN"
2023,Apr,19375,18720,655,3.4,"McLeod County, MN"
2023,May,19351,18800,551,2.8,"McLeod County, MN"
2023,Jun,19581,18849,732,3.7,"McLeod County, MN"
2023,Jul,19400,18779,621,3.2,"McLeod County, MN"
2023,Aug,19458,18797,661,3.4,"McLeod County, MN"
2023,Sep,19209,18785,424,2.2,"McLeod County, MN"
2023,Oct,19232,18830,402,2.1,"McLeod County, MN"
2023,Nov,19166,18798,368,1.9,"McLeod County, MN"
2023,Dec,19179,18588,591,3.1,"McLeod County, MN"
2024,Jan,19351,18579,772,4.0,"McLeod County, MN"
2024,Feb,19363,18536,827,4.3,"McLeod County, MN"
2024,Mar,19431,18703,728,3.7,"McLeod County, MN"
2024,Apr,19416,18847,569,2.9,"McLeod County, MN"
2024,May,19267,18691,576,3.0,"McLeod County, MN"
2024,Jun,19584,18719,865,4.4,"McLeod County, MN"
2024,Jul,19525,18722,803,4.1,"McLeod County, MN"
2024,Aug,19691,18858,833,4.2,"McLeod County, MN"
2024,Sep,19440,18889,551,2.8,"McLeod County, MN"
2024,Oct,19386,18889,497,2.6,"McLeod County, MN"
2024,Nov,19430(P),18827(P),603(P),3.1(P),"McLeod County, MN"
P : Preliminary.,P : Preliminary.,P : Preliminary.,P : Preliminary.,P : Preliminary.,P : Preliminary.,"McLeod County, MN"
2014,Jan,2346,2177,169,7.2,"Mahnomen County, MN"
2014,Feb,2374,2207,167,7.0,"Mahnomen County, MN"
2014,Mar,2398,2224,174,7.3,"Mahnomen County, MN"
2014,Apr,2372,2232,140,5.9,"Mahnomen County, MN"
2014,May,2393,2269,124,5.2,"Mahnomen County, MN"
2014,Jun,2382,2238,144,6.0,"Mahnomen County, MN"
2014,Jul,2348,2207,141,6.0,"Mahnomen County, MN"
2014,Aug,2352,2230,122,5.2,"Mahnomen County, MN"
2014,Sep,2334,2227,107,4.6,"Mahnomen County, MN"
2014,Oct,2388,2288,100,4.2,"Mahnomen County, MN"
2014,Nov,2351,2245,106,4.5,"Mahnomen County, MN"
2014,Dec,2372,2225,147,6.2,"Mahnomen County, MN"
2015,Jan,2397,2223,174,7.3,"Mahnomen County, MN"
2015,Feb,2370,2203,167,7.0,"Mahnomen County, MN"
2015,Mar,2414,2247,167,6.9,"Mahnomen County, MN"
2015,Apr,2417,2282,135,5.6,"Mahnomen County, MN"
2015,May,2421,2295,126,5.2,"Mahnomen County, MN"
2015,Jun,2427,2272,155,6.4,"Mahnomen County, MN"
2015,Jul,2381,2244,137,5.8,"Mahnomen County, MN"
2015,Aug,2391,2262,129,5.4,"Mahnomen County, MN"
2015,Sep,2447,2334,113,4.6,"Mahnomen County, MN"
2015,Oct,2409,2293,116,4.8,"Mahnomen County, MN"
2015,Nov,2403,2282,121,5.0,"Mahnomen County, MN"
2015,Dec,2480,2303,177,7.1,"Mahnomen County, MN"
2016,Jan,2434,2269,165,6.8,"Mahnomen County, MN"
2016,Feb,2402,2242,160,6.7,"Mahnomen County, MN"
2016,Mar,2460,2277,183,7.4,"Mahnomen County, MN"
2016,Apr,2417,2273,144,6.0,"Mahnomen County, MN"
2016,May,2418,2306,112,4.6,"Mahnomen County, MN"
2016,Jun,2371,2222,149,6.3,"Mahnomen County, MN"
2016,Jul,2330,2185,145,6.2,"Mahnomen County, MN"
2016,Aug,2354,2218,136,5.8,"Mahnomen County, MN"
2016,Sep,2370,2260,110,4.6,"Mahnomen County, MN"
2016,Oct,2340,2241,99,4.2,"Mahnomen County, MN"
2016,Nov,2348,2244,104,4.4,"Mahnomen County, MN"
2016,Dec,2403,2258,145,6.0,"Mahnomen County, MN"
2017,Jan,2425,2241,184,7.6,"Mahnomen County, MN"
2017,Feb,2398,2238,160,6.7,"Mahnomen County, MN"
2017,Mar,2434,2281,153,6.3,"Mahnomen County, MN"
2017,Apr,2417,2290,127,5.3,"Mahnomen County, MN"
2017,May,2407,2302,105,4.4,"Mahnomen County, MN"
2017,Jun,2395,2261,134,5.6,"Mahnomen County, MN"
2017,Jul,2331,2205,126,5.4,"Mahnomen County, MN"
2017,Aug,2292,2182,110,4.8,"Mahnomen County, MN"
2017,Sep,2337,2261,76,3.3,"Mahnomen County, MN"
2017,Oct,2333,2265,68,2.9,"Mahnomen County, MN"
2017,Nov,2322,2239,83,3.6,"Mahnomen County, MN"
2017,Dec,2373,2258,115,4.8,"Mahnomen County, MN"
2018,Jan,2326,2176,150,6.4,"Mahnomen County, MN"
2018,Feb,2360,2214,146,6.2,"Mahnomen County, MN"
2018,Mar,2385,2229,156,6.5,"Mahnomen County, MN"
2018,Apr,2363,2241,122,5.2,"Mahnomen County, MN"
2018,May,2368,2281,87,3.7,"Mahnomen County, MN"
2018,Jun,2351,2246,105,4.5,"Mahnomen County, MN"
2018,Jul,2268,2171,97,4.3,"Mahnomen County, MN"
2018,Aug,2219,2133,86,3.9,"Mahnomen County, MN"
2018,Sep,2299,2228,71,3.1,"Mahnomen County, MN"
2018,Oct,2327,2243,84,3.6,"Mahnomen County, MN"
2018,Nov,2299,2210,89,3.9,"Mahnomen County, MN"
2018,Dec,2350,2223,127,5.4,"Mahnomen County, MN"
2019,Jan,2325,2171,154,6.6,"Mahnomen County, MN"
2019,Feb,2317,2167,150,6.5,"Mahnomen County, MN"
2019,Mar,2318,2176,142,6.1,"Mahnomen County, MN"
2019,Apr,2305,2195,110,4.8,"Mahnomen County, MN"
2019,May,2342,2260,82,3.5,"Mahnomen County, MN"
2019,Jun,2371,2265,106,4.5,"Mahnomen County, MN"
2019,Jul,2272,2177,95,4.2,"Mahnomen County, MN"
2019,Aug,2223,2149,74,3.3,"Mahnomen County, MN"
2019,Sep,2296,2216,80,3.5,"Mahnomen County, MN"
2019,Oct,2312,2231,81,3.5,"Mahnomen County, MN"
2019,Nov,2290,2179,111,4.8,"Mahnomen County, MN"
2019,Dec,2342,2201,141,6.0,"Mahnomen County, MN"
2020,Jan,2361,2175,186,7.9,"Mahnomen County, MN"
2020,Feb,2351,2183,168,7.1,"Mahnomen County, MN"
2020,Mar,2357,2168,189,8.0,"Mahnomen County, MN"
2020,Apr,2046,1600,446,21.8,"Mahnomen County, MN"
2020,May,2118,1570,548,25.9,"Mahnomen County, MN"
2020,Jun,2289,1833,456,19.9,"Mahnomen County, MN"
2020,Jul,2260,1877,383,16.9,"Mahnomen County, MN"
2020,Aug,2184,1876,308,14.1,"Mahnomen County, MN"
2020,Sep,2214,1935,279,12.6,"Mahnomen County, MN"
2020,Oct,2177,1987,190,8.7,"Mahnomen County, MN"
2020,Nov,2134,1958,176,8.2,"Mahnomen County, MN"
2020,Dec,2121,1949,172,8.1,"Mahnomen County, MN"
2021,Jan,2144,1935,209,9.7,"Mahnomen County, MN"
2021,Feb,2134,1954,180,8.4,"Mahnomen County, MN"
2021,Mar,2124,1951,173,8.1,"Mahnomen County, MN"
2021,Apr,2167,2014,153,7.1,"Mahnomen County, MN"
2021,May,2187,2064,123,5.6,"Mahnomen County, MN"
2021,Jun,2216,2068,148,6.7,"Mahnomen County, MN"
2021,Jul,2218,2082,136,6.1,"Mahnomen County, MN"
2021,Aug,2198,2070,128,5.8,"Mahnomen County, MN"
2021,Sep,2233,2134,99,4.4,"Mahnomen County, MN"
2021,Oct,2210,2114,96,4.3,"Mahnomen County, MN"
2021,Nov,2174,2062,112,5.2,"Mahnomen County, MN"
2021,Dec,2235,2082,153,6.8,"Mahnomen County, MN"
2022,Jan,2198,2044,154,7.0,"Mahnomen County, MN"
2022,Feb,2190,2046,144,6.6,"Mahnomen County, MN"
2022,Mar,2205,2079,126,5.7,"Mahnomen County, MN"
2022,Apr,2182,2084,98,4.5,"Mahnomen County, MN"
2022,May,2224,2145,79,3.6,"Mahnomen County, MN"
2022,Jun,2244,2153,91,4.1,"Mahnomen County, MN"
2022,Jul,2205,2117,88,4.0,"Mahnomen County, MN"
2022,Aug,2214,2123,91,4.1,"Mahnomen County, MN"
2022,Sep,2265,2196,69,3.0,"Mahnomen County, MN"
2022,Oct,2278,2198,80,3.5,"Mahnomen County, MN"
2022,Nov,2229,2135,94,4.2,"Mahnomen County, MN"
2022,Dec,2264,2128,136,6.0,"Mahnomen County, MN"
2023,Jan,2276,2126,150,6.6,"Mahnomen County, MN"
2023,Feb,2257,2108,149,6.6,"Mahnomen County, MN"
2023,Mar,2269,2118,151,6.7,"Mahnomen County, MN"
2023,Apr,2242,2106,136,6.1,"Mahnomen County, MN"
2023,May,2297,2206,91,4.0,"Mahnomen County, MN"
2023,Jun,2345,2230,115,4.9,"Mahnomen County, MN"
2023,Jul,2300,2186,114,5.0,"Mahnomen County, MN"
2023,Aug,2319,2209,110,4.7,"Mahnomen County, MN"
2023,Sep,2336,2274,62,2.7,"Mahnomen County, MN"
2023,Oct,2324,2259,65,2.8,"Mahnomen County, MN"
2023,Nov,2308,2234,74,3.2,"Mahnomen County, MN"
2023,Dec,2298,2208,90,3.9,"Mahnomen County, MN"
2024,Jan,2317,2200,117,5.0,"Mahnomen County, MN"
2024,Feb,2318,2192,126,5.4,"Mahnomen County, MN"
2024,Mar,2344,2233,111,4.7,"Mahnomen County, MN"
2024,Apr,2354,2250,104,4.4,"Mahnomen County, MN"
2024,May,2359,2260,99,4.2,"Mahnomen County, MN"
2024,Jun,2413,2268,145,6.0,"Mahnomen County, MN"
2024,Jul,2389,2242,147,6.2,"Mahnomen County, MN"
2024,Aug,2420,2284,136,5.6,"Mahnomen County, MN"
2024,Sep,2434,2357,77,3.2,"Mahnomen County, MN"
2024,Oct,2397,2330,67,2.8,"Mahnomen County, MN"
2024,Nov,2381(P),2293(P),88(P),3.7(P),"Mahnomen County, MN"
P : Preliminary.,P : Preliminary.,P : Preliminary.,P : Preliminary.,P : Preliminary.,P : Preliminary.,"Mahnomen County, MN"
2014,Jan,5544,4945,599,10.8,"Marshall County, MN"
2014,Feb,5528,4957,571,10.3,"Marshall County, MN"
2014,Mar,5620,4998,622,11.1,"Marshall County, MN"
2014,Apr,5506,5048,458,8.3,"Marshall County, MN"
2014,May,5554,5243,311,5.6,"Marshall County, MN"
2014,Jun,5696,5395,301,5.3,"Marshall County, MN"
2014,Jul,5566,5272,294,5.3,"Marshall County, MN"
2014,Aug,5517,5261,256,4.6,"Marshall County, MN"
2014,Sep,5551,5332,219,3.9,"Marshall County, MN"
2014,Oct,5696,5490,206,3.6,"Marshall County, MN"
2014,Nov,5712,5388,324,5.7,"Marshall County, MN"
2014,Dec,5787,5303,484,8.4,"Marshall County, MN"
2015,Jan,5817,5232,585,10.1,"Marshall County, MN"
2015,Feb,5706,5156,550,9.6,"Marshall County, MN"
2015,Mar,5904,5327,577,9.8,"Marshall County, MN"
2015,Apr,5721,5263,458,8.0,"Marshall County, MN"
2015,May,5694,5361,333,5.8,"Marshall County, MN"
2015,Jun,5907,5548,359,6.1,"Marshall County, MN"
2015,Jul,5623,5306,317,5.6,"Marshall County, MN"
2015,Aug,5542,5257,285,5.1,"Marshall County, MN"
2015,Sep,5528,5294,234,4.2,"Marshall County, MN"
2015,Oct,5884,5644,240,4.1,"Marshall County, MN"
2015,Nov,5858,5488,370,6.3,"Marshall County, MN"
2015,Dec,5949,5388,561,9.4,"Marshall County, MN"
2016,Jan,5844,5256,588,10.1,"Marshall County, MN"
2016,Feb,5639,5075,564,10.0,"Marshall County, MN"
2016,Mar,5803,5180,623,10.7,"Marshall County, MN"
2016,Apr,5686,5206,480,8.4,"Marshall County, MN"
2016,May,5560,5255,305,5.5,"Marshall County, MN"
2016,Jun,5662,5341,321,5.7,"Marshall County, MN"
2016,Jul,5434,5120,314,5.8,"Marshall County, MN"
2016,Aug,5326,5025,301,5.7,"Marshall County, MN"
2016,Sep,5323,5076,247,4.6,"Marshall County, MN"
2016,Oct,5647,5392,255,4.5,"Marshall County, MN"
2016,Nov,5711,5352,359,6.3,"Marshall County, MN"
2016,Dec,5741,5166,575,10.0,"Marshall County, MN"
2017,Jan,5806,5154,652,11.2,"Marshall County, MN"
2017,Feb,5627,5048,579,10.3,"Marshall County, MN"
2017,Mar,5745,5171,574,10.0,"Marshall County, MN"
2017,Apr,5597,5116,481,8.6,"Marshall County, MN"
2017,May,5522,5245,277,5.0,"Marshall County, MN"
2017,Jun,5514,5231,283,5.1,"Marshall County, MN"
2017,Jul,5278,5025,253,4.8,"Marshall County, MN"
2017,Aug,5131,4873,258,5.0,"Marshall County, MN"
2017,Sep,5202,5007,195,3.7,"Marshall County, MN"
2017,Oct,5496,5313,183,3.3,"Marshall County, MN"
2017,Nov,5548,5163,385,6.9,"Marshall County, MN"
2017,Dec,5565,5068,497,8.9,"Marshall County, MN"
2018,Jan,5483,4915,568,10.4,"Marshall County, MN"
2018,Feb,5494,4968,526,9.6,"Marshall County, MN"
2018,Mar,5549,5007,542,9.8,"Marshall County, MN"
2018,Apr,5471,5105,366,6.7,"Marshall County, MN"
2018,May,5527,5312,215,3.9,"Marshall County, MN"
2018,Jun,5521,5285,236,4.3,"Marshall County, MN"
2018,Jul,5395,5168,227,4.2,"Marshall County, MN"
2018,Aug,5113,4919,194,3.8,"Marshall County, MN"
2018,Sep,5295,5133,162,3.1,"Marshall County, MN"
2018,Oct,5415,5245,170,3.1,"Marshall County, MN"
2018,Nov,5394,5134,260,4.8,"Marshall County, MN"
2018,Dec,5466,5051,415,7.6,"Marshall County, MN"
2019,Jan,5439,4848,591,10.9,"Marshall County, MN"
2019,Feb,5357,4839,518,9.7,"Marshall County, MN"
2019,Mar,5365,4879,486,9.1,"Marshall County, MN"
2019,Apr,5463,5077,386,7.1,"Marshall County, MN"
2019,May,5531,5299,232,4.2,"Marshall County, MN"
2019,Jun,5524,5302,222,4.0,"Marshall County, MN"
2019,Jul,5432,5213,219,4.0,"Marshall County, MN"
2019,Aug,5219,5030,189,3.6,"Marshall County, MN"
2019,Sep,5361,5199,162,3.0,"Marshall County, MN"
2019,Oct,5551,5381,170,3.1,"Marshall County, MN"
2019,Nov,5435,5177,258,4.7,"Marshall County, MN"
2019,Dec,5515,5082,433,7.9,"Marshall County, MN"
2020,Jan,5401,4824,577,10.7,"Marshall County, MN"
2020,Feb,5353,4854,499,9.3,"Marshall County, MN"
2020,Mar,5374,4825,549,10.2,"Marshall County, MN"
2020,Apr,5297,4821,476,9.0,"Marshall County, MN"
2020,May,5405,4953,452,8.4,"Marshall County, MN"
2020,Jun,5668,5310,358,6.3,"Marshall County, MN"
2020,Jul,5605,5325,280,5.0,"Marshall County, MN"
2020,Aug,5405,5204,201,3.7,"Marshall County, MN"
2020,Sep,5446,5278,168,3.1,"Marshall County, MN"
2020,Oct,5724,5551,173,3.0,"Marshall County, MN"
2020,Nov,5594,5311,283,5.1,"Marshall County, MN"
2020,Dec,5489,5159,330,6.0,"Marshall County, MN"
2021,Jan,5345,4934,411,7.7,"Marshall County, MN"
2021,Feb,5306,4927,379,7.1,"Marshall County, MN"
2021,Mar,5247,4903,344,6.6,"Marshall County, MN"
2021,Apr,5244,4979,265,5.1,"Marshall County, MN"
2021,May,5322,5145,177,3.3,"Marshall County, MN"
2021,Jun,5333,5153,180,3.4,"Marshall County, MN"
2021,Jul,5308,5146,162,3.1,"Marshall County, MN"
2021,Aug,5189,5032,157,3.0,"Marshall County, MN"
2021,Sep,5257,5127,130,2.5,"Marshall County, MN"
2021,Oct,5406,5278,128,2.4,"Marshall County, MN"
2021,Nov,5305,5115,190,3.6,"Marshall County, MN"
2021,Dec,5450,5151,299,5.5,"Marshall County, MN"
2022,Jan,5390,5032,358,6.6,"Marshall County, MN"
2022,Feb,5387,5061,326,6.1,"Marshall County, MN"
2022,Mar,5415,5118,297,5.5,"Marshall County, MN"
2022,Apr,5253,5038,215,4.1,"Marshall County, MN"
2022,May,5315,5155,160,3.0,"Marshall County, MN"
2022,Jun,5367,5218,149,2.8,"Marshall County, MN"
2022,Jul,5373,5234,139,2.6,"Marshall County, MN"
2022,Aug,5232,5103,129,2.5,"Marshall County, MN"
2022,Sep,5283,5190,93,1.8,"Marshall County, MN"
2022,Oct,5435,5330,105,1.9,"Marshall County, MN"
2022,Nov,5348,5153,195,3.6,"Marshall County, MN"
2022,Dec,5501,5204,297,5.4,"Marshall County, MN"
2023,Jan,5434,5074,360,6.6,"Marshall County, MN"
2023,Feb,5469,5097,372,6.8,"Marshall County, MN"
2023,Mar,5499,5162,337,6.1,"Marshall County, MN"
2023,Apr,5386,5124,262,4.9,"Marshall County, MN"
2023,May,5391,5199,192,3.6,"Marshall County, MN"
2023,Jun,5435,5233,202,3.7,"Marshall County, MN"
2023,Jul,5291,5102,189,3.6,"Marshall County, MN"
2023,Aug,5412,5225,187,3.5,"Marshall County, MN"
2023,Sep,5434,5322,112,2.1,"Marshall County, MN"
2023,Oct,5532,5431,101,1.8,"Marshall County, MN"
2023,Nov,5524,5346,178,3.2,"Marshall County, MN"
2023,Dec,5369,5126,243,4.5,"Marshall County, MN"
2024,Jan,5369,5040,329,6.1,"Marshall County, MN"
2024,Feb,5363,5024,339,6.3,"Marshall County, MN"
2024,Mar,5517,5203,314,5.7,"Marshall County, MN"
2024,Apr,5465,5241,224,4.1,"Marshall County, MN"
2024,May,5389,5182,207,3.8,"Marshall County, MN"
2024,Jun,5600,5353,247,4.4,"Marshall County, MN"
2024,Jul,5578,5307,271,4.9,"Marshall County, MN"
2024,Aug,5687,5453,234,4.1,"Marshall County, MN"
2024,Sep,5690,5551,139,2.4,"Marshall County, MN"
2024,Oct,5657,5538,119,2.1,"Marshall County, MN"
2024,Nov,5660(P),5478(P),182(P),3.2(P),"Marshall County, MN"
P : Preliminary.,P : Preliminary.,P : Preliminary.,P : Preliminary.,P : Preliminary.,P : Preliminary.,"Marshall County, MN"
2014,Jan,10181,9566,615,6.0,"Martin County, MN"
2014,Feb,10110,9493,617,6.1,"Martin County, MN"
2014,Mar,10181,9581,600,5.9,"Martin County, MN"
2014,Apr,10067,9594,473,4.7,"Martin County, MN"
2014,May,10101,9693,408,4.0,"Martin County, MN"
2014,Jun,10262,9798,464,4.5,"Martin County, MN"
2014,Jul,10534,9989,545,5.2,"Martin County, MN"
2014,Aug,10446,10003,443,4.2,"Martin County, MN"
2014,Sep,10037,9636,401,4.0,"Martin County, MN"
2014,Oct,10444,9955,489,4.7,"Martin County, MN"
2014,Nov,10298,9898,400,3.9,"Martin County, MN"
2014,Dec,10279,9807,472,4.6,"Martin County, MN"
2015,Jan,10370,9840,530,5.1,"Martin County, MN"
2015,Feb,10157,9653,504,5.0,"Martin County, MN"
2015,Mar,10412,9910,502,4.8,"Martin County, MN"
2015,Apr,10357,9942,415,4.0,"Martin County, MN"
2015,May,10464,10036,428,4.1,"Martin County, MN"
2015,Jun,10801,10295,506,4.7,"Martin County, MN"
2015,Jul,10590,10185,405,3.8,"Martin County, MN"
2015,Aug,10556,10154,402,3.8,"Martin County, MN"
2015,Sep,10264,9873,391,3.8,"Martin County, MN"
2015,Oct,10586,10264,322,3.0,"Martin County, MN"
2015,Nov,10502,10194,308,2.9,"Martin County, MN"
2015,Dec,10616,10109,507,4.8,"Martin County, MN"
2016,Jan,10547,10052,495,4.7,"Martin County, MN"
2016,Feb,10358,9869,489,4.7,"Martin County, MN"
2016,Mar,10494,9989,505,4.8,"Martin County, MN"
2016,Apr,10441,10058,383,3.7,"Martin County, MN"
2016,May,10480,10060,420,4.0,"Martin County, MN"
2016,Jun,10692,10159,533,5.0,"Martin County, MN"
2016,Jul,10526,10064,462,4.4,"Martin County, MN"
2016,Aug,10478,10092,386,3.7,"Martin County, MN"
2016,Sep,10109,9738,371,3.7,"Martin County, MN"
2016,Oct,10456,10092,364,3.5,"Martin County, MN"
2016,Nov,10451,10109,342,3.3,"Martin County, MN"
2016,Dec,10432,10021,411,3.9,"Martin County, MN"
2017,Jan,10527,10054,473,4.5,"Martin County, MN"
2017,Feb,10452,10013,439,4.2,"Martin County, MN"
2017,Mar,10546,10117,429,4.1,"Martin County, MN"
2017,Apr,10557,10212,345,3.3,"Martin County, MN"
2017,May,10513,10190,323,3.1,"Martin County, MN"
2017,Jun,10645,10268,377,3.5,"Martin County, MN"
2017,Jul,10475,10120,355,3.4,"Martin County, MN"
2017,Aug,10405,10033,372,3.6,"Martin County, MN"
2017,Sep,10150,9829,321,3.2,"Martin County, MN"
2017,Oct,10416,10128,288,2.8,"Martin County, MN"
2017,Nov,10373,10082,291,2.8,"Martin County, MN"
2017,Dec,10447,10076,371,3.6,"Martin County, MN"
2018,Jan,10232,9836,396,3.9,"Martin County, MN"
2018,Feb,10221,9824,397,3.9,"Martin County, MN"
2018,Mar,10219,9827,392,3.8,"Martin County, MN"
2018,Apr,10294,9981,313,3.0,"Martin County, MN"
2018,May,10432,10163,269,2.6,"Martin County, MN"
2018,Jun,10549,10176,373,3.5,"Martin County, MN"
2018,Jul,10596,10262,334,3.2,"Martin County, MN"
2018,Aug,10198,9880,318,3.1,"Martin County, MN"
2018,Sep,10061,9791,270,2.7,"Martin County, MN"
2018,Oct,10188,9911,277,2.7,"Martin County, MN"
2018,Nov,10112,9844,268,2.7,"Martin County, MN"
2018,Dec,10178,9784,394,3.9,"Martin County, MN"
2019,Jan,9920,9463,457,4.6,"Martin County, MN"
2019,Feb,9899,9456,443,4.5,"Martin County, MN"
2019,Mar,9873,9458,415,4.2,"Martin County, MN"
2019,Apr,10042,9699,343,3.4,"Martin County, MN"
2019,May,10293,9971,322,3.1,"Martin County, MN"
2019,Jun,10468,9981,487,4.7,"Martin County, MN"
2019,Jul,10628,10045,583,5.5,"Martin County, MN"
2019,Aug,10205,9825,380,3.7,"Martin County, MN"
2019,Sep,9958,9658,300,3.0,"Martin County, MN"
2019,Oct,10115,9825,290,2.9,"Martin County, MN"
2019,Nov,9879,9610,269,2.7,"Martin County, MN"
2019,Dec,9969,9623,346,3.5,"Martin County, MN"
2020,Jan,9778,9366,412,4.2,"Martin County, MN"
2020,Feb,9800,9401,399,4.1,"Martin County, MN"
2020,Mar,9733,9239,494,5.1,"Martin County, MN"
2020,Apr,9796,9082,714,7.3,"Martin County, MN"
2020,May,9925,9047,878,8.8,"Martin County, MN"
2020,Jun,10510,9723,787,7.5,"Martin County, MN"
2020,Jul,10735,10027,708,6.6,"Martin County, MN"
2020,Aug,10443,9980,463,4.4,"Martin County, MN"
2020,Sep,10004,9592,412,4.1,"Martin County, MN"
2020,Oct,10416,9899,517,5.0,"Martin County, MN"
2020,Nov,10027,9688,339,3.4,"Martin County, MN"
2020,Dec,9978,9554,424,4.2,"Martin County, MN"
2021,Jan,9644,9177,467,4.8,"Martin County, MN"
2021,Feb,9594,9199,395,4.1,"Martin County, MN"
2021,Mar,9456,9045,411,4.3,"Martin County, MN"
2021,Apr,9488,9165,323,3.4,"Martin County, MN"
2021,May,9663,9323,340,3.5,"Martin County, MN"
2021,Jun,9858,9394,464,4.7,"Martin County, MN"
2021,Jul,9961,9608,353,3.5,"Martin County, MN"
2021,Aug,9885,9559,326,3.3,"Martin County, MN"
2021,Sep,9551,9281,270,2.8,"Martin County, MN"
2021,Oct,9677,9445,232,2.4,"Martin County, MN"
2021,Nov,9536,9337,199,2.1,"Martin County, MN"
2021,Dec,9761,9498,263,2.7,"Martin County, MN"
2022,Jan,9602,9277,325,3.4,"Martin County, MN"
2022,Feb,9649,9360,289,3.0,"Martin County, MN"
2022,Mar,9548,9264,284,3.0,"Martin County, MN"
2022,Apr,9416,9224,192,2.0,"Martin County, MN"
2022,May,9580,9341,239,2.5,"Martin County, MN"
2022,Jun,9682,9406,276,2.9,"Martin County, MN"
2022,Jul,9908,9635,273,2.8,"Martin County, MN"
2022,Aug,9802,9551,251,2.6,"Martin County, MN"
2022,Sep,9471,9289,182,1.9,"Martin County, MN"
2022,Oct,9731,9552,179,1.8,"Martin County, MN"
2022,Nov,9594,9402,192,2.0,"Martin County, MN"
2022,Dec,9769,9500,269,2.8,"Martin County, MN"
2023,Jan,9722,9411,311,3.2,"Martin County, MN"
2023,Feb,9778,9431,347,3.5,"Martin County, MN"
2023,Mar,9682,9359,323,3.3,"Martin County, MN"
2023,Apr,9575,9310,265,2.8,"Martin County, MN"
2023,May,9636,9402,234,2.4,"Martin County, MN"
2023,Jun,9735,9387,348,3.6,"Martin County, MN"
2023,Jul,9810,9490,320,3.3,"Martin County, MN"
2023,Aug,10072,9764,308,3.1,"Martin County, MN"
2023,Sep,9831,9596,235,2.4,"Martin County, MN"
2023,Oct,9930,9718,212,2.1,"Martin County, MN"
2023,Nov,9885,9711,174,1.8,"Martin County, MN"
2023,Dec,9769,9521,248,2.5,"Martin County, MN"
2024,Jan,9712,9398,314,3.2,"Martin County, MN"
2024,Feb,9724,9373,351,3.6,"Martin County, MN"
2024,Mar,9853,9543,310,3.1,"Martin County, MN"
2024,Apr,9863,9609,254,2.6,"Martin County, MN"
2024,May,9690,9430,260,2.7,"Martin County, MN"
2024,Jun,9973,9577,396,4.0,"Martin County, MN"
2024,Jul,10107,9711,396,3.9,"Martin County, MN"
2024,Aug,10447,10041,406,3.9,"Martin County, MN"
2024,Sep,10084,9809,275,2.7,"Martin County, MN"
2024,Oct,10064,9808,256,2.5,"Martin County, MN"
2024,Nov,10089(P),9793(P),296(P),2.9(P),"Martin County, MN"
P : Preliminary.,P : Preliminary.,P : Preliminary.,P : Preliminary.,P : Preliminary.,P : Preliminary.,"Martin County, MN"
2014,Jan,12688,11825,863,6.8,"Meeker County, MN"
2014,Feb,12685,11837,848,6.7,"Meeker County, MN"
2014,Mar,12728,11884,844,6.6,"Meeker County, MN"
2014,Apr,12682,12021,661,5.2,"Meeker County, MN"
2014,May,12721,12207,514,4.0,"Meeker County, MN"
2014,Jun,12889,12351,538,4.2,"Meeker County, MN"
2014,Jul,12947,12425,522,4.0,"Meeker County, MN"
2014,Aug,12976,12494,482,3.7,"Meeker County, MN"
2014,Sep,13036,12603,433,3.3,"Meeker County, MN"
2014,Oct,13096,12702,394,3.0,"Meeker County, MN"
2014,Nov,13067,12543,524,4.0,"Meeker County, MN"
2014,Dec,13165,12511,654,5.0,"Meeker County, MN"
2015,Jan,13449,12657,792,5.9,"Meeker County, MN"
2015,Feb,13337,12547,790,5.9,"Meeker County, MN"
2015,Mar,13509,12709,800,5.9,"Meeker County, MN"
2015,Apr,13370,12814,556,4.2,"Meeker County, MN"
2015,May,13337,12870,467,3.5,"Meeker County, MN"
2015,Jun,13560,13036,524,3.9,"Meeker County, MN"
2015,Jul,13336,12837,499,3.7,"Meeker County, MN"
2015,Aug,13312,12847,465,3.5,"Meeker County, MN"
2015,Sep,13108,12707,401,3.1,"Meeker County, MN"
2015,Oct,13349,12942,407,3.0,"Meeker County, MN"
2015,Nov,13320,12859,461,3.5,"Meeker County, MN"
2015,Dec,13487,12771,716,5.3,"Meeker County, MN"
2016,Jan,13471,12658,813,6.0,"Meeker County, MN"
2016,Feb,13336,12540,796,6.0,"Meeker County, MN"
2016,Mar,13483,12650,833,6.2,"Meeker County, MN"
2016,Apr,13316,12734,582,4.4,"Meeker County, MN"
2016,May,13162,12694,468,3.6,"Meeker County, MN"
2016,Jun,13287,12731,556,4.2,"Meeker County, MN"
2016,Jul,13220,12684,536,4.1,"Meeker County, MN"
2016,Aug,13168,12651,517,3.9,"Meeker County, MN"
2016,Sep,12943,12486,457,3.5,"Meeker County, MN"
2016,Oct,13199,12765,434,3.3,"Meeker County, MN"
2016,Nov,13209,12741,468,3.5,"Meeker County, MN"
2016,Dec,13251,12569,682,5.1,"Meeker County, MN"
2017,Jan,13410,12590,820,6.1,"Meeker County, MN"
2017,Feb,13305,12508,797,6.0,"Meeker County, MN"
2017,Mar,13447,12693,754,5.6,"Meeker County, MN"
2017,Apr,13450,12881,569,4.2,"Meeker County, MN"
2017,May,13292,12867,425,3.2,"Meeker County, MN"
2017,Jun,13455,12941,514,3.8,"Meeker County, MN"
2017,Jul,13328,12864,464,3.5,"Meeker County, MN"
2017,Aug,13211,12742,469,3.6,"Meeker County, MN"
2017,Sep,13087,12710,377,2.9,"Meeker County, MN"
2017,Oct,13215,12880,335,2.5,"Meeker County, MN"
2017,Nov,13212,12795,417,3.2,"Meeker County, MN"
2017,Dec,13225,12650,575,4.3,"Meeker County, MN"
2018,Jan,13047,12355,692,5.3,"Meeker County, MN"
2018,Feb,13157,12475,682,5.2,"Meeker County, MN"
2018,Mar,13167,12486,681,5.2,"Meeker County, MN"
2018,Apr,13259,12697,562,4.2,"Meeker County, MN"
2018,May,13304,12956,348,2.6,"Meeker County, MN"
2018,Jun,13323,12908,415,3.1,"Meeker County, MN"
2018,Jul,13340,12958,382,2.9,"Meeker County, MN"
2018,Aug,13000,12648,352,2.7,"Meeker County, MN"
2018,Sep,12951,12652,299,2.3,"Meeker County, MN"
2018,Oct,13173,12856,317,2.4,"Meeker County, MN"
2018,Nov,13066,12734,332,2.5,"Meeker County, MN"
2018,Dec,13318,12718,600,4.5,"Meeker County, MN"
2019,Jan,13363,12545,818,6.1,"Meeker County, MN"
2019,Feb,13271,12554,717,5.4,"Meeker County, MN"
2019,Mar,13317,12584,733,5.5,"Meeker County, MN"
2019,Apr,13353,12808,545,4.1,"Meeker County, MN"
2019,May,13445,13065,380,2.8,"Meeker County, MN"
2019,Jun,13528,13060,468,3.5,"Meeker County, MN"
2019,Jul,13556,13130,426,3.1,"Meeker County, MN"
2019,Aug,13389,12977,412,3.1,"Meeker County, MN"
2019,Sep,13356,13012,344,2.6,"Meeker County, MN"
2019,Oct,13485,13150,335,2.5,"Meeker County, MN"
2019,Nov,13360,12951,409,3.1,"Meeker County, MN"
2019,Dec,13564,12865,699,5.2,"Meeker County, MN"
2020,Jan,13411,12579,832,6.2,"Meeker County, MN"
2020,Feb,13374,12643,731,5.5,"Meeker County, MN"
2020,Mar,13288,12426,862,6.5,"Meeker County, MN"
2020,Apr,12803,11942,861,6.7,"Meeker County, MN"
2020,May,12976,12036,940,7.2,"Meeker County, MN"
2020,Jun,13524,12688,836,6.2,"Meeker County, MN"
2020,Jul,13699,12951,748,5.5,"Meeker County, MN"
2020,Aug,13481,12937,544,4.0,"Meeker County, MN"
2020,Sep,13292,12794,498,3.7,"Meeker County, MN"
2020,Oct,13602,13146,456,3.4,"Meeker County, MN"
2020,Nov,13459,12896,563,4.2,"Meeker County, MN"
2020,Dec,13431,12733,698,5.2,"Meeker County, MN"
2021,Jan,13226,12410,816,6.2,"Meeker County, MN"
2021,Feb,13154,12397,757,5.8,"Meeker County, MN"
2021,Mar,13042,12359,683,5.2,"Meeker County, MN"
2021,Apr,13124,12577,547,4.2,"Meeker County, MN"
2021,May,13125,12732,393,3.0,"Meeker County, MN"
2021,Jun,13222,12765,457,3.5,"Meeker County, MN"
2021,Jul,13306,12901,405,3.0,"Meeker County, MN"
2021,Aug,13255,12864,391,2.9,"Meeker County, MN"
2021,Sep,13113,12783,330,2.5,"Meeker County, MN"
2021,Oct,13411,13125,286,2.1,"Meeker County, MN"
2021,Nov,13327,13043,284,2.1,"Meeker County, MN"
2021,Dec,13530,13086,444,3.3,"Meeker County, MN"
2022,Jan,13542,12949,593,4.4,"Meeker County, MN"
2022,Feb,13552,13000,552,4.1,"Meeker County, MN"
2022,Mar,13498,12997,501,3.7,"Meeker County, MN"
2022,Apr,13383,13032,351,2.6,"Meeker County, MN"
2022,May,13460,13219,241,1.8,"Meeker County, MN"
2022,Jun,13475,13167,308,2.3,"Meeker County, MN"
2022,Jul,13664,13370,294,2.2,"Meeker County, MN"
2022,Aug,13635,13336,299,2.2,"Meeker County, MN"
2022,Sep,13554,13316,238,1.8,"Meeker County, MN"
2022,Oct,13739,13477,262,1.9,"Meeker County, MN"
2022,Nov,13723,13379,344,2.5,"Meeker County, MN"
2022,Dec,14016,13454,562,4.0,"Meeker County, MN"
2023,Jan,13856,13224,632,4.6,"Meeker County, MN"
2023,Feb,13828,13196,632,4.6,"Meeker County, MN"
2023,Mar,13888,13278,610,4.4,"Meeker County, MN"
2023,Apr,13890,13392,498,3.6,"Meeker County, MN"
2023,May,13844,13499,345,2.5,"Meeker County, MN"
2023,Jun,13982,13539,443,3.2,"Meeker County, MN"
2023,Jul,13911,13481,430,3.1,"Meeker County, MN"
2023,Aug,14067,13624,443,3.1,"Meeker County, MN"
2023,Sep,13853,13584,269,1.9,"Meeker County, MN"
2023,Oct,13964,13705,259,1.9,"Meeker County, MN"
2023,Nov,13955,13684,271,1.9,"Meeker County, MN"
2023,Dec,13858,13433,425,3.1,"Meeker County, MN"
2024,Jan,13909,13322,587,4.2,"Meeker County, MN"
2024,Feb,13919,13284,635,4.6,"Meeker County, MN"
2024,Mar,14055,13483,572,4.1,"Meeker County, MN"
2024,Apr,14074,13626,448,3.2,"Meeker County, MN"
2024,May,13911,13496,415,3.0,"Meeker County, MN"
2024,Jun,14114,13558,556,3.9,"Meeker County, MN"
2024,Jul,14180,13632,548,3.9,"Meeker County, MN"
2024,Aug,14407,13862,545,3.8,"Meeker County, MN"
2024,Sep,14211,13868,343,2.4,"Meeker County, MN"
2024,Oct,14207,13899,308,2.2,"Meeker County, MN"
2024,Nov,14267(P),13855(P),412(P),2.9(P),"Meeker County, MN"
P : Preliminary.,P : Preliminary.,P : Preliminary.,P : Preliminary.,P : Preliminary.,P : Preliminary.,"Meeker County, MN"
2014,Jan,12837,11591,1246,9.7,"Mille Lacs County, MN"
2014,Feb,12863,11607,1256,9.8,"Mille Lacs County, MN"
2014,Mar,12916,11656,1260,9.8,"Mille Lacs County, MN"
2014,Apr,12750,11770,980,7.7,"Mille Lacs County, MN"
2014,May,12616,11861,755,6.0,"Mille Lacs County, MN"
2014,Jun,12693,11914,779,6.1,"Mille Lacs County, MN"
2014,Jul,12718,12009,709,5.6,"Mille Lacs County, MN"
2014,Aug,12605,11937,668,5.3,"Mille Lacs County, MN"
2014,Sep,12505,11903,602,4.8,"Mille Lacs County, MN"
2014,Oct,12558,11996,562,4.5,"Mille Lacs County, MN"
2014,Nov,12741,11990,751,5.9,"Mille Lacs County, MN"
2014,Dec,12819,11915,904,7.1,"Mille Lacs County, MN"
2015,Jan,12727,11687,1040,8.2,"Mille Lacs County, MN"
2015,Feb,12735,11722,1013,8.0,"Mille Lacs County, MN"
2015,Mar,12769,11742,1027,8.0,"Mille Lacs County, MN"
2015,Apr,12627,11885,742,5.9,"Mille Lacs County, MN"
2015,May,12615,11979,636,5.0,"Mille Lacs County, MN"
2015,Jun,12658,11974,684,5.4,"Mille Lacs County, MN"
2015,Jul,12694,12056,638,5.0,"Mille Lacs County, MN"
2015,Aug,12560,11979,581,4.6,"Mille Lacs County, MN"
2015,Sep,12418,11890,528,4.3,"Mille Lacs County, MN"
2015,Oct,12481,11971,510,4.1,"Mille Lacs County, MN"
2015,Nov,12626,11984,642,5.1,"Mille Lacs County, MN"
2015,Dec,12890,11941,949,7.4,"Mille Lacs County, MN"
2016,Jan,12859,11787,1072,8.3,"Mille Lacs County, MN"
2016,Feb,12897,11846,1051,8.1,"Mille Lacs County, MN"
2016,Mar,12924,11838,1086,8.4,"Mille Lacs County, MN"
2016,Apr,12738,11953,785,6.2,"Mille Lacs County, MN"
2016,May,12576,11990,586,4.7,"Mille Lacs County, MN"
2016,Jun,12591,11957,634,5.0,"Mille Lacs County, MN"
2016,Jul,12704,12114,590,4.6,"Mille Lacs County, MN"
2016,Aug,12644,12044,600,4.7,"Mille Lacs County, MN"
2016,Sep,12583,12011,572,4.5,"Mille Lacs County, MN"
2016,Oct,12571,12010,561,4.5,"Mille Lacs County, MN"
2016,Nov,12648,12005,643,5.1,"Mille Lacs County, MN"
2016,Dec,12865,11936,929,7.2,"Mille Lacs County, MN"
2017,Jan,12964,11804,1160,8.9,"Mille Lacs County, MN"
2017,Feb,12946,11868,1078,8.3,"Mille Lacs County, MN"
2017,Mar,12983,11939,1044,8.0,"Mille Lacs County, MN"
2017,Apr,12778,12041,737,5.8,"Mille Lacs County, MN"
2017,May,12597,12065,532,4.2,"Mille Lacs County, MN"
2017,Jun,12688,12130,558,4.4,"Mille Lacs County, MN"
2017,Jul,12787,12251,536,4.2,"Mille Lacs County, MN"
2017,Aug,12684,12147,537,4.2,"Mille Lacs County, MN"
2017,Sep,12664,12193,471,3.7,"Mille Lacs County, MN"
2017,Oct,12614,12158,456,3.6,"Mille Lacs County, MN"
2017,Nov,12789,12163,626,4.9,"Mille Lacs County, MN"
2017,Dec,12970,12090,880,6.8,"Mille Lacs County, MN"
2018,Jan,13119,12062,1057,8.1,"Mille Lacs County, MN"
2018,Feb,13141,12158,983,7.5,"Mille Lacs County, MN"
2018,Mar,13079,12097,982,7.5,"Mille Lacs County, MN"
2018,Apr,12884,12138,746,5.8,"Mille Lacs County, MN"
2018,May,12722,12243,479,3.8,"Mille Lacs County, MN"
2018,Jun,12744,12262,482,3.8,"Mille Lacs County, MN"
2018,Jul,12815,12384,431,3.4,"Mille Lacs County, MN"
2018,Aug,12663,12232,431,3.4,"Mille Lacs County, MN"
2018,Sep,12577,12239,338,2.7,"Mille Lacs County, MN"
2018,Oct,12651,12281,370,2.9,"Mille Lacs County, MN"
2018,Nov,12776,12285,491,3.8,"Mille Lacs County, MN"
2018,Dec,13089,12232,857,6.5,"Mille Lacs County, MN"
2019,Jan,13337,12129,1208,9.1,"Mille Lacs County, MN"
2019,Feb,13260,12187,1073,8.1,"Mille Lacs County, MN"
2019,Mar,13204,12150,1054,8.0,"Mille Lacs County, MN"
2019,Apr,13005,12238,767,5.9,"Mille Lacs County, MN"
2019,May,12806,12310,496,3.9,"Mille Lacs County, MN"
2019,Jun,12915,12375,540,4.2,"Mille Lacs County, MN"
2019,Jul,13008,12493,515,4.0,"Mille Lacs County, MN"
2019,Aug,12913,12421,492,3.8,"Mille Lacs County, MN"
2019,Sep,12850,12423,427,3.3,"Mille Lacs County, MN"
2019,Oct,12902,12451,451,3.5,"Mille Lacs County, MN"
2019,Nov,13025,12428,597,4.6,"Mille Lacs County, MN"
2019,Dec,13335,12402,933,7.0,"Mille Lacs County, MN"
2020,Jan,13412,12233,1179,8.8,"Mille Lacs County, MN"
2020,Feb,13398,12295,1103,8.2,"Mille Lacs County, MN"
2020,Mar,13353,12098,1255,9.4,"Mille Lacs County, MN"
2020,Apr,12466,11024,1442,11.6,"Mille Lacs County, MN"
2020,May,12533,10898,1635,13.0,"Mille Lacs County, MN"
2020,Jun,12912,11632,1280,9.9,"Mille Lacs County, MN"
2020,Jul,13016,11893,1123,8.6,"Mille Lacs County, MN"
2020,Aug,12921,12052,869,6.7,"Mille Lacs County, MN"
2020,Sep,12801,11971,830,6.5,"Mille Lacs County, MN"
2020,Oct,12843,12106,737,5.7,"Mille Lacs County, MN"
2020,Nov,12893,12067,826,6.4,"Mille Lacs County, MN"
2020,Dec,12873,11782,1091,8.5,"Mille Lacs County, MN"
2021,Jan,12826,11595,1231,9.6,"Mille Lacs County, MN"
2021,Feb,12795,11641,1154,9.0,"Mille Lacs County, MN"
2021,Mar,12667,11628,1039,8.2,"Mille Lacs County, MN"
2021,Apr,12531,11722,809,6.5,"Mille Lacs County, MN"
2021,May,12353,11786,567,4.6,"Mille Lacs County, MN"
2021,Jun,12377,11771,606,4.9,"Mille Lacs County, MN"
2021,Jul,12482,11948,534,4.3,"Mille Lacs County, MN"
2021,Aug,12379,11873,506,4.1,"Mille Lacs County, MN"
2021,Sep,12270,11825,445,3.6,"Mille Lacs County, MN"
2021,Oct,12357,11946,411,3.3,"Mille Lacs County, MN"
2021,Nov,12460,12010,450,3.6,"Mille Lacs County, MN"
2021,Dec,12695,11992,703,5.5,"Mille Lacs County, MN"
2022,Jan,12855,11910,945,7.4,"Mille Lacs County, MN"
2022,Feb,12801,11970,831,6.5,"Mille Lacs County, MN"
2022,Mar,12721,11973,748,5.9,"Mille Lacs County, MN"
2022,Apr,12602,12090,512,4.1,"Mille Lacs County, MN"
2022,May,12515,12155,360,2.9,"Mille Lacs County, MN"
2022,Jun,12483,12097,386,3.1,"Mille Lacs County, MN"
2022,Jul,12567,12225,342,2.7,"Mille Lacs County, MN"
2022,Aug,12573,12176,397,3.2,"Mille Lacs County, MN"
2022,Sep,12468,12142,326,2.6,"Mille Lacs County, MN"
2022,Oct,12442,12099,343,2.8,"Mille Lacs County, MN"
2022,Nov,12538,12055,483,3.9,"Mille Lacs County, MN"
2022,Dec,12878,12049,829,6.4,"Mille Lacs County, MN"
2023,Jan,13046,12015,1031,7.9,"Mille Lacs County, MN"
2023,Feb,13090,12036,1054,8.1,"Mille Lacs County, MN"
2023,Mar,13076,12077,999,7.6,"Mille Lacs County, MN"
2023,Apr,12922,12151,771,6.0,"Mille Lacs County, MN"
2023,May,12706,12204,502,4.0,"Mille Lacs County, MN"
2023,Jun,12812,12238,574,4.5,"Mille Lacs County, MN"
2023,Jul,12807,12296,511,4.0,"Mille Lacs County, MN"
2023,Aug,12769,12231,538,4.2,"Mille Lacs County, MN"
2023,Sep,12579,12234,345,2.7,"Mille Lacs County, MN"
2023,Oct,12566,12222,344,2.7,"Mille Lacs County, MN"
2023,Nov,12647,12240,407,3.2,"Mille Lacs County, MN"
2023,Dec,12782,12086,696,5.4,"Mille Lacs County, MN"
2024,Jan,13025,12041,984,7.6,"Mille Lacs County, MN"
2024,Feb,13071,12066,1005,7.7,"Mille Lacs County, MN"
2024,Mar,13074,12139,935,7.2,"Mille Lacs County, MN"
2024,Apr,12886,12198,688,5.3,"Mille Lacs County, MN"
2024,May,12779,12116,663,5.2,"Mille Lacs County, MN"
2024,Jun,12654,11993,661,5.2,"Mille Lacs County, MN"
2024,Jul,12721,12057,664,5.2,"Mille Lacs County, MN"
2024,Aug,12721,12043,678,5.3,"Mille Lacs County, MN"
2024,Sep,12545,12086,459,3.7,"Mille Lacs County, MN"
2024,Oct,12570,12131,439,3.5,"Mille Lacs County, MN"
2024,Nov,12664(P),12085(P),579(P),4.6(P),"Mille Lacs County, MN"
P : Preliminary.,P : Preliminary.,P : Preliminary.,P : Preliminary.,P : Preliminary.,P : Preliminary.,"Mille Lacs County, MN"
2014,Jan,17334,15707,1627,9.4,"Morrison County, MN"
2014,Feb,17364,15795,1569,9.0,"Morrison County, MN"
2014,Mar,17558,15900,1658,9.4,"Morrison County, MN"
2014,Apr,17348,16063,1285,7.4,"Morrison County, MN"
2014,May,17247,16344,903,5.2,"Morrison County, MN"
2014,Jun,17431,16504,927,5.3,"Morrison County, MN"
2014,Jul,17622,16754,868,4.9,"Morrison County, MN"
2014,Aug,17473,16661,812,4.6,"Morrison County, MN"
2014,Sep,17182,16448,734,4.3,"Morrison County, MN"
2014,Oct,17534,16832,702,4.0,"Morrison County, MN"
2014,Nov,17590,16571,1019,5.8,"Morrison County, MN"
2014,Dec,17618,16350,1268,7.2,"Morrison County, MN"
2015,Jan,17820,16337,1483,8.3,"Morrison County, MN"
2015,Feb,17725,16292,1433,8.1,"Morrison County, MN"
2015,Mar,17899,16583,1316,7.4,"Morrison County, MN"
2015,Apr,17808,16850,958,5.4,"Morrison County, MN"
2015,May,17730,16930,800,4.5,"Morrison County, MN"
2015,Jun,18022,17197,825,4.6,"Morrison County, MN"
2015,Jul,17852,17093,759,4.3,"Morrison County, MN"
2015,Aug,17684,16969,715,4.0,"Morrison County, MN"
2015,Sep,17418,16772,646,3.7,"Morrison County, MN"
2015,Oct,18033,17350,683,3.8,"Morrison County, MN"
2015,Nov,17961,17072,889,4.9,"Morrison County, MN"
2015,Dec,18187,16888,1299,7.1,"Morrison County, MN"
2016,Jan,18225,16713,1512,8.3,"Morrison County, MN"
2016,Feb,17985,16567,1418,7.9,"Morrison County, MN"
2016,Mar,18189,16721,1468,8.1,"Morrison County, MN"
2016,Apr,17871,16912,959,5.4,"Morrison County, MN"
2016,May,17757,17034,723,4.1,"Morrison County, MN"
2016,Jun,17842,17030,812,4.6,"Morrison County, MN"
2016,Jul,17704,16948,756,4.3,"Morrison County, MN"
2016,Aug,17529,16751,778,4.4,"Morrison County, MN"
2016,Sep,17383,16676,707,4.1,"Morrison County, MN"
2016,Oct,17861,17149,712,4.0,"Morrison County, MN"
2016,Nov,17897,17015,882,4.9,"Morrison County, MN"
2016,Dec,18033,16722,1311,7.3,"Morrison County, MN"
2017,Jan,18321,16731,1590,8.7,"Morrison County, MN"
2017,Feb,18036,16614,1422,7.9,"Morrison County, MN"
2017,Mar,18162,16757,1405,7.7,"Morrison County, MN"
2017,Apr,17833,16860,973,5.5,"Morrison County, MN"
2017,May,17704,17020,684,3.9,"Morrison County, MN"
2017,Jun,17786,17060,726,4.1,"Morrison County, MN"
2017,Jul,17538,16862,676,3.9,"Morrison County, MN"
2017,Aug,17293,16615,678,3.9,"Morrison County, MN"
2017,Sep,17216,16651,565,3.3,"Morrison County, MN"
2017,Oct,17599,17064,535,3.0,"Morrison County, MN"
2017,Nov,17628,16728,900,5.1,"Morrison County, MN"
2017,Dec,17864,16581,1283,7.2,"Morrison County, MN"
2018,Jan,17693,16227,1466,8.3,"Morrison County, MN"
2018,Feb,17771,16451,1320,7.4,"Morrison County, MN"
2018,Mar,17863,16603,1260,7.1,"Morrison County, MN"
2018,Apr,17728,16793,935,5.3,"Morrison County, MN"
2018,May,17769,17188,581,3.3,"Morrison County, MN"
2018,Jun,17610,16992,618,3.5,"Morrison County, MN"
2018,Jul,17587,17032,555,3.2,"Morrison County, MN"
2018,Aug,17020,16521,499,2.9,"Morrison County, MN"
2018,Sep,17202,16776,426,2.5,"Morrison County, MN"
2018,Oct,17376,16886,490,2.8,"Morrison County, MN"
2018,Nov,17423,16660,763,4.4,"Morrison County, MN"
2018,Dec,17771,16509,1262,7.1,"Morrison County, MN"
2019,Jan,17747,16133,1614,9.1,"Morrison County, MN"
2019,Feb,17607,16192,1415,8.0,"Morrison County, MN"
2019,Mar,17652,16333,1319,7.5,"Morrison County, MN"
2019,Apr,17648,16761,887,5.0,"Morrison County, MN"
2019,May,17740,17145,595,3.4,"Morrison County, MN"
2019,Jun,17793,17141,652,3.7,"Morrison County, MN"
2019,Jul,17736,17057,679,3.8,"Morrison County, MN"
2019,Aug,17334,16714,620,3.6,"Morrison County, MN"
2019,Sep,17341,16815,526,3.0,"Morrison County, MN"
2019,Oct,17715,17136,579,3.3,"Morrison County, MN"
2019,Nov,17631,16761,870,4.9,"Morrison County, MN"
2019,Dec,17982,16622,1360,7.6,"Morrison County, MN"
2020,Jan,17856,16297,1559,8.7,"Morrison County, MN"
2020,Feb,17888,16471,1417,7.9,"Morrison County, MN"
2020,Mar,17945,16390,1555,8.7,"Morrison County, MN"
2020,Apr,17595,16028,1567,8.9,"Morrison County, MN"
2020,May,17613,15933,1680,9.5,"Morrison County, MN"
2020,Jun,18145,16889,1256,6.9,"Morrison County, MN"
2020,Jul,18362,17300,1062,5.8,"Morrison County, MN"
2020,Aug,18118,17348,770,4.2,"Morrison County, MN"
2020,Sep,17918,17203,715,4.0,"Morrison County, MN"
2020,Oct,18480,17677,803,4.3,"Morrison County, MN"
2020,Nov,18262,17165,1097,6.0,"Morrison County, MN"
2020,Dec,18087,16755,1332,7.4,"Morrison County, MN"
2021,Jan,17704,16219,1485,8.4,"Morrison County, MN"
2021,Feb,17701,16305,1396,7.9,"Morrison County, MN"
2021,Mar,17590,16321,1269,7.2,"Morrison County, MN"
2021,Apr,17549,16680,869,5.0,"Morrison County, MN"
2021,May,17570,16913,657,3.7,"Morrison County, MN"
2021,Jun,17590,16909,681,3.9,"Morrison County, MN"
2021,Jul,17574,16989,585,3.3,"Morrison County, MN"
2021,Aug,17478,16924,554,3.2,"Morrison County, MN"
2021,Sep,17295,16830,465,2.7,"Morrison County, MN"
2021,Oct,17407,16983,424,2.4,"Morrison County, MN"
2021,Nov,17312,16722,590,3.4,"Morrison County, MN"
2021,Dec,17630,16698,932,5.3,"Morrison County, MN"
2022,Jan,17590,16360,1230,7.0,"Morrison County, MN"
2022,Feb,17548,16429,1119,6.4,"Morrison County, MN"
2022,Mar,17483,16485,998,5.7,"Morrison County, MN"
2022,Apr,17067,16356,711,4.2,"Morrison County, MN"
2022,May,17156,16658,498,2.9,"Morrison County, MN"
2022,Jun,17272,16723,549,3.2,"Morrison County, MN"
2022,Jul,17075,16578,497,2.9,"Morrison County, MN"
2022,Aug,16934,16411,523,3.1,"Morrison County, MN"
2022,Sep,16945,16565,380,2.2,"Morrison County, MN"
2022,Oct,17218,16812,406,2.4,"Morrison County, MN"
2022,Nov,17025,16367,658,3.9,"Morrison County, MN"
2022,Dec,17556,16440,1116,6.4,"Morrison County, MN"
2023,Jan,17662,16367,1295,7.3,"Morrison County, MN"
2023,Feb,17780,16493,1287,7.2,"Morrison County, MN"
2023,Mar,17815,16603,1212,6.8,"Morrison County, MN"
2023,Apr,17505,16598,907,5.2,"Morrison County, MN"
2023,May,17384,16816,568,3.3,"Morrison County, MN"
2023,Jun,17482,16779,703,4.0,"Morrison County, MN"
2023,Jul,17525,16900,625,3.6,"Morrison County, MN"
2023,Aug,17786,17140,646,3.6,"Morrison County, MN"
2023,Sep,17606,17232,374,2.1,"Morrison County, MN"
2023,Oct,17686,17306,380,2.1,"Morrison County, MN"
2023,Nov,17692,17159,533,3.0,"Morrison County, MN"
2023,Dec,17608,16734,874,5.0,"Morrison County, MN"
2024,Jan,17747,16562,1185,6.7,"Morrison County, MN"
2024,Feb,17759,16527,1232,6.9,"Morrison County, MN"
2024,Mar,17990,16889,1101,6.1,"Morrison County, MN"
2024,Apr,17882,17082,800,4.5,"Morrison County, MN"
2024,May,17681,16901,780,4.4,"Morrison County, MN"
2024,Jun,17944,17081,863,4.8,"Morrison County, MN"
2024,Jul,17991,17146,845,4.7,"Morrison County, MN"
2024,Aug,18324,17484,840,4.6,"Morrison County, MN"
2024,Sep,18040,17544,496,2.7,"Morrison County, MN"
2024,Oct,17980,17498,482,2.7,"Morrison County, MN"
2024,Nov,18029(P),17334(P),695(P),3.9(P),"Morrison County, MN"
P : Preliminary.,P : Preliminary.,P : Preliminary.,P : Preliminary.,P : Preliminary.,P : Preliminary.,"Morrison County, MN"
2014,Jan,20056,19070,986,4.9,"Mower County, MN"
2014,Feb,20170,19170,1000,5.0,"Mower County, MN"
2014,Mar,20290,19300,990,4.9,"Mower County, MN"
2014,Apr,20235,19417,818,4.0,"Mower County, MN"
2014,May,20283,19510,773,3.8,"Mower County, MN"
2014,Jun,20510,19684,826,4.0,"Mower County, MN"
2014,Jul,20452,19640,812,4.0,"Mower County, MN"
2014,Aug,20435,19698,737,3.6,"Mower County, MN"
2014,Sep,20257,19597,660,3.3,"Mower County, MN"
2014,Oct,20446,19827,619,3.0,"Mower County, MN"
2014,Nov,20406,19784,622,3.0,"Mower County, MN"
2014,Dec,20346,19650,696,3.4,"Mower County, MN"
2015,Jan,20365,19502,863,4.2,"Mower County, MN"
2015,Feb,20325,19467,858,4.2,"Mower County, MN"
2015,Mar,20375,19533,842,4.1,"Mower County, MN"
2015,Apr,20236,19575,661,3.3,"Mower County, MN"
2015,May,20265,19628,637,3.1,"Mower County, MN"
2015,Jun,20553,19854,699,3.4,"Mower County, MN"
2015,Jul,20332,19664,668,3.3,"Mower County, MN"
2015,Aug,20265,19678,587,2.9,"Mower County, MN"
2015,Sep,20284,19742,542,2.7,"Mower County, MN"
2015,Oct,20592,20049,543,2.6,"Mower County, MN"
2015,Nov,20694,20166,528,2.6,"Mower County, MN"
2015,Dec,20602,20001,601,2.9,"Mower County, MN"
2016,Jan,20608,19843,765,3.7,"Mower County, MN"
2016,Feb,20507,19723,784,3.8,"Mower County, MN"
2016,Mar,20716,19924,792,3.8,"Mower County, MN"
2016,Apr,20581,19956,625,3.0,"Mower County, MN"
2016,May,20479,19927,552,2.7,"Mower County, MN"
2016,Jun,20739,20061,678,3.3,"Mower County, MN"
2016,Jul,20458,19839,619,3.0,"Mower County, MN"
2016,Aug,20378,19774,604,3.0,"Mower County, MN"
2016,Sep,20333,19732,601,3.0,"Mower County, MN"
2016,Oct,20422,19850,572,2.8,"Mower County, MN"
2016,Nov,20516,19984,532,2.6,"Mower County, MN"
2016,Dec,20334,19677,657,3.2,"Mower County, MN"
2017,Jan,20575,19783,792,3.8,"Mower County, MN"
2017,Feb,20621,19838,783,3.8,"Mower County, MN"
2017,Mar,20776,20026,750,3.6,"Mower County, MN"
2017,Apr,20801,20200,601,2.9,"Mower County, MN"
2017,May,20847,20294,553,2.7,"Mower County, MN"
2017,Jun,21071,20440,631,3.0,"Mower County, MN"
2017,Jul,20592,20037,555,2.7,"Mower County, MN"
2017,Aug,20461,19911,550,2.7,"Mower County, MN"
2017,Sep,20488,20023,465,2.3,"Mower County, MN"
2017,Oct,20562,20153,409,2.0,"Mower County, MN"
2017,Nov,20651,20219,432,2.1,"Mower County, MN"
2017,Dec,20394,19856,538,2.6,"Mower County, MN"
2018,Jan,20355,19672,683,3.4,"Mower County, MN"
2018,Feb,20502,19823,679,3.3,"Mower County, MN"
2018,Mar,20580,19901,679,3.3,"Mower County, MN"
2018,Apr,20654,20128,526,2.5,"Mower County, MN"
2018,May,20669,20197,472,2.3,"Mower County, MN"
2018,Jun,20739,20129,610,2.9,"Mower County, MN"
2018,Jul,20356,19802,554,2.7,"Mower County, MN"
2018,Aug,20094,19565,529,2.6,"Mower County, MN"
2018,Sep,20237,19745,492,2.4,"Mower County, MN"
2018,Oct,20233,19749,484,2.4,"Mower County, MN"
2018,Nov,20216,19755,461,2.3,"Mower County, MN"
2018,Dec,20273,19613,660,3.3,"Mower County, MN"
2019,Jan,20300,19525,775,3.8,"Mower County, MN"
2019,Feb,20327,19600,727,3.6,"Mower County, MN"
2019,Mar,20353,19607,746,3.7,"Mower County, MN"
2019,Apr,20405,19820,585,2.9,"Mower County, MN"
2019,May,20572,20008,564,2.7,"Mower County, MN"
2019,Jun,20708,20029,679,3.3,"Mower County, MN"
2019,Jul,20584,19946,638,3.1,"Mower County, MN"
2019,Aug,20302,19709,593,2.9,"Mower County, MN"
2019,Sep,20440,19922,518,2.5,"Mower County, MN"
2019,Oct,20775,20256,519,2.5,"Mower County, MN"
2019,Nov,20645,20115,530,2.6,"Mower County, MN"
2019,Dec,20790,20142,648,3.1,"Mower County, MN"
2020,Jan,20766,20019,747,3.6,"Mower County, MN"
2020,Feb,20760,20028,732,3.5,"Mower County, MN"
2020,Mar,20801,19863,938,4.5,"Mower County, MN"
2020,Apr,20614,19397,1217,5.9,"Mower County, MN"
2020,May,20645,18961,1684,8.2,"Mower County, MN"
2020,Jun,21368,19816,1552,7.3,"Mower County, MN"
2020,Jul,21348,20011,1337,6.3,"Mower County, MN"
2020,Aug,21112,20119,993,4.7,"Mower County, MN"
2020,Sep,21218,20269,949,4.5,"Mower County, MN"
2020,Oct,21236,20303,933,4.4,"Mower County, MN"
2020,Nov,20904,20113,791,3.8,"Mower County, MN"
2020,Dec,20629,19727,902,4.4,"Mower County, MN"
2021,Jan,20771,19783,988,4.8,"Mower County, MN"
2021,Feb,20706,19789,917,4.4,"Mower County, MN"
2021,Mar,20672,19791,881,4.3,"Mower County, MN"
2021,Apr,20699,19987,712,3.4,"Mower County, MN"
2021,May,20735,20075,660,3.2,"Mower County, MN"
2021,Jun,20853,20035,818,3.9,"Mower County, MN"
2021,Jul,20515,19803,712,3.5,"Mower County, MN"
2021,Aug,20394,19714,680,3.3,"Mower County, MN"
2021,Sep,20608,20046,562,2.7,"Mower County, MN"
2021,Oct,20680,20192,488,2.4,"Mower County, MN"
2021,Nov,20770,20348,422,2.0,"Mower County, MN"
2021,Dec,20939,20413,526,2.5,"Mower County, MN"
2022,Jan,20635,19967,668,3.2,"Mower County, MN"
2022,Feb,20819,20213,606,2.9,"Mower County, MN"
2022,Mar,20992,20401,591,2.8,"Mower County, MN"
2022,Apr,20614,20211,403,2.0,"Mower County, MN"
2022,May,20757,20346,411,2.0,"Mower County, MN"
2022,Jun,20861,20335,526,2.5,"Mower County, MN"
2022,Jul,20571,20089,482,2.3,"Mower County, MN"
2022,Aug,20512,19998,514,2.5,"Mower County, MN"
2022,Sep,20734,20333,401,1.9,"Mower County, MN"
2022,Oct,20673,20256,417,2.0,"Mower County, MN"
2022,Nov,20674,20248,426,2.1,"Mower County, MN"
2022,Dec,20841,20266,575,2.8,"Mower County, MN"
2023,Jan,21046,20383,663,3.2,"Mower County, MN"
2023,Feb,21231,20539,692,3.3,"Mower County, MN"
2023,Mar,21343,20687,656,3.1,"Mower County, MN"
2023,Apr,21233,20708,525,2.5,"Mower County, MN"
2023,May,21302,20780,522,2.5,"Mower County, MN"
2023,Jun,21471,20795,676,3.1,"Mower County, MN"
2023,Jul,21047,20434,613,2.9,"Mower County, MN"
2023,Aug,21338,20690,648,3.0,"Mower County, MN"
2023,Sep,21238,20813,425,2.0,"Mower County, MN"
2023,Oct,21263,20844,419,2.0,"Mower County, MN"
2023,Nov,21319,20974,345,1.6,"Mower County, MN"
2023,Dec,21105,20640,465,2.2,"Mower County, MN"
2024,Jan,21313,20724,589,2.8,"Mower County, MN"
2024,Feb,21374,20699,675,3.2,"Mower County, MN"
2024,Mar,21522,20959,563,2.6,"Mower County, MN"
2024,Apr,21545,21036,509,2.4,"Mower County, MN"
2024,May,21326,20823,503,2.4,"Mower County, MN"
2024,Jun,21693,20930,763,3.5,"Mower County, MN"
2024,Jul,21546,20794,752,3.5,"Mower County, MN"
2024,Aug,21794,21062,732,3.4,"Mower County, MN"
2024,Sep,21866,21353,513,2.3,"Mower County, MN"
2024,Oct,21765,21304,461,2.1,"Mower County, MN"
2024,Nov,21906(P),21396(P),510(P),2.3(P),"Mower County, MN"
P : Preliminary.,P : Preliminary.,P : Preliminary.,P : Preliminary.,P : Preliminary.,P : Preliminary.,"Mower County, MN"
2014,Jan,4751,4375,376,7.9,"Murray County, MN"
2014,Feb,4727,4351,376,8.0,"Murray County, MN"
2014,Mar,4799,4421,378,7.9,"Murray County, MN"
2014,Apr,4823,4552,271,5.6,"Murray County, MN"
2014,May,4791,4619,172,3.6,"Murray County, MN"
2014,Jun,4927,4704,223,4.5,"Murray County, MN"
2014,Jul,4920,4746,174,3.5,"Murray County, MN"
2014,Aug,4865,4711,154,3.2,"Murray County, MN"
2014,Sep,4832,4694,138,2.9,"Murray County, MN"
2014,Oct,5004,4832,172,3.4,"Murray County, MN"
2014,Nov,4941,4750,191,3.9,"Murray County, MN"
2014,Dec,5058,4773,285,5.6,"Murray County, MN"
2015,Jan,5060,4677,383,7.6,"Murray County, MN"
2015,Feb,4972,4591,381,7.7,"Murray County, MN"
2015,Mar,5121,4756,365,7.1,"Murray County, MN"
2015,Apr,5001,4795,206,4.1,"Murray County, MN"
2015,May,4972,4800,172,3.5,"Murray County, MN"
2015,Jun,5143,4956,187,3.6,"Murray County, MN"
2015,Jul,5023,4856,167,3.3,"Murray County, MN"
2015,Aug,4964,4813,151,3.0,"Murray County, MN"
2015,Sep,4954,4815,139,2.8,"Murray County, MN"
2015,Oct,5262,5112,150,2.9,"Murray County, MN"
2015,Nov,5177,5002,175,3.4,"Murray County, MN"
2015,Dec,5250,4975,275,5.2,"Murray County, MN"
2016,Jan,5150,4794,356,6.9,"Murray County, MN"
2016,Feb,4940,4582,358,7.2,"Murray County, MN"
2016,Mar,5074,4712,362,7.1,"Murray County, MN"
2016,Apr,4980,4741,239,4.8,"Murray County, MN"
2016,May,4947,4786,161,3.3,"Murray County, MN"
2016,Jun,4976,4800,176,3.5,"Murray County, MN"
2016,Jul,4866,4677,189,3.9,"Murray County, MN"
2016,Aug,4781,4619,162,3.4,"Murray County, MN"
2016,Sep,4753,4594,159,3.3,"Murray County, MN"
2016,Oct,5022,4836,186,3.7,"Murray County, MN"
2016,Nov,4972,4815,157,3.2,"Murray County, MN"
2016,Dec,4978,4670,308,6.2,"Murray County, MN"
2017,Jan,5029,4633,396,7.9,"Murray County, MN"
2017,Feb,4886,4527,359,7.3,"Murray County, MN"
2017,Mar,4972,4625,347,7.0,"Murray County, MN"
2017,Apr,4954,4747,207,4.2,"Murray County, MN"
2017,May,4924,4763,161,3.3,"Murray County, MN"
2017,Jun,4930,4768,162,3.3,"Murray County, MN"
2017,Jul,4784,4636,148,3.1,"Murray County, MN"
2017,Aug,4740,4569,171,3.6,"Murray County, MN"
2017,Sep,4794,4638,156,3.3,"Murray County, MN"
2017,Oct,4987,4874,113,2.3,"Murray County, MN"
2017,Nov,4931,4779,152,3.1,"Murray County, MN"
2017,Dec,4949,4711,238,4.8,"Murray County, MN"
2018,Jan,4846,4519,327,6.7,"Murray County, MN"
2018,Feb,4865,4569,296,6.1,"Murray County, MN"
2018,Mar,4880,4589,291,6.0,"Murray County, MN"
2018,Apr,4907,4696,211,4.3,"Murray County, MN"
2018,May,4991,4867,124,2.5,"Murray County, MN"
2018,Jun,4993,4859,134,2.7,"Murray County, MN"
2018,Jul,4915,4785,130,2.6,"Murray County, MN"
2018,Aug,4685,4570,115,2.5,"Murray County, MN"
2018,Sep,4838,4721,117,2.4,"Murray County, MN"
2018,Oct,4921,4810,111,2.3,"Murray County, MN"
2018,Nov,4811,4678,133,2.8,"Murray County, MN"
2018,Dec,4959,4703,256,5.2,"Murray County, MN"
2019,Jan,4801,4421,380,7.9,"Murray County, MN"
2019,Feb,4736,4413,323,6.8,"Murray County, MN"
2019,Mar,4807,4489,318,6.6,"Murray County, MN"
2019,Apr,4913,4700,213,4.3,"Murray County, MN"
2019,May,4982,4854,128,2.6,"Murray County, MN"
2019,Jun,5038,4877,161,3.2,"Murray County, MN"
2019,Jul,4893,4711,182,3.7,"Murray County, MN"
2019,Aug,4726,4554,172,3.6,"Murray County, MN"
2019,Sep,4838,4693,145,3.0,"Murray County, MN"
2019,Oct,4983,4858,125,2.5,"Murray County, MN"
2019,Nov,4809,4683,126,2.6,"Murray County, MN"
2019,Dec,4921,4658,263,5.3,"Murray County, MN"
2020,Jan,4645,4304,341,7.3,"Murray County, MN"
2020,Feb,4640,4329,311,6.7,"Murray County, MN"
2020,Mar,4636,4282,354,7.6,"Murray County, MN"
2020,Apr,4792,4508,284,5.9,"Murray County, MN"
2020,May,4793,4520,273,5.7,"Murray County, MN"
2020,Jun,5066,4823,243,4.8,"Murray County, MN"
2020,Jul,5040,4808,232,4.6,"Murray County, MN"
2020,Aug,4863,4688,175,3.6,"Murray County, MN"
2020,Sep,4890,4721,169,3.5,"Murray County, MN"
2020,Oct,5089,4914,175,3.4,"Murray County, MN"
2020,Nov,5003,4802,201,4.0,"Murray County, MN"
2020,Dec,5069,4818,251,5.0,"Murray County, MN"
2021,Jan,4840,4479,361,7.5,"Murray County, MN"
2021,Feb,4737,4415,322,6.8,"Murray County, MN"
2021,Mar,4700,4407,293,6.2,"Murray County, MN"
2021,Apr,4726,4521,205,4.3,"Murray County, MN"
2021,May,4700,4557,143,3.0,"Murray County, MN"
2021,Jun,4805,4628,177,3.7,"Murray County, MN"
2021,Jul,4743,4586,157,3.3,"Murray County, MN"
2021,Aug,4665,4537,128,2.7,"Murray County, MN"
2021,Sep,4583,4465,118,2.6,"Murray County, MN"
2021,Oct,4728,4628,100,2.1,"Murray County, MN"
2021,Nov,4605,4498,107,2.3,"Murray County, MN"
2021,Dec,4864,4688,176,3.6,"Murray County, MN"
2022,Jan,4682,4414,268,5.7,"Murray County, MN"
2022,Feb,4660,4408,252,5.4,"Murray County, MN"
2022,Mar,4648,4438,210,4.5,"Murray County, MN"
2022,Apr,4564,4415,149,3.3,"Murray County, MN"
2022,May,4653,4552,101,2.2,"Murray County, MN"
2022,Jun,4704,4592,112,2.4,"Murray County, MN"
2022,Jul,4670,4560,110,2.4,"Murray County, MN"
2022,Aug,4593,4504,89,1.9,"Murray County, MN"
2022,Sep,4575,4502,73,1.6,"Murray County, MN"
2022,Oct,4637,4551,86,1.9,"Murray County, MN"
2022,Nov,4550,4443,107,2.4,"Murray County, MN"
2022,Dec,4756,4531,225,4.7,"Murray County, MN"
2023,Jan,4686,4390,296,6.3,"Murray County, MN"
2023,Feb,4715,4401,314,6.7,"Murray County, MN"
2023,Mar,4652,4387,265,5.7,"Murray County, MN"
2023,Apr,4639,4444,195,4.2,"Murray County, MN"
2023,May,4631,4511,120,2.6,"Murray County, MN"
2023,Jun,4653,4472,181,3.9,"Murray County, MN"
2023,Jul,4594,4410,184,4.0,"Murray County, MN"
2023,Aug,4746,4580,166,3.5,"Murray County, MN"
2023,Sep,4673,4560,113,2.4,"Murray County, MN"
2023,Oct,4744,4642,102,2.2,"Murray County, MN"
2023,Nov,4706,4607,99,2.1,"Murray County, MN"
2023,Dec,4637,4485,152,3.3,"Murray County, MN"
2024,Jan,4537,4297,240,5.3,"Murray County, MN"
2024,Feb,4506,4259,247,5.5,"Murray County, MN"
2024,Mar,4620,4412,208,4.5,"Murray County, MN"
2024,Apr,4658,4508,150,3.2,"Murray County, MN"
2024,May,4588,4442,146,3.2,"Murray County, MN"
2024,Jun,4788,4591,197,4.1,"Murray County, MN"
2024,Jul,4754,4549,205,4.3,"Murray County, MN"
2024,Aug,4935,4737,198,4.0,"Murray County, MN"
2024,Sep,4878,4763,115,2.4,"Murray County, MN"
2024,Oct,4828,4727,101,2.1,"Murray County, MN"
2024,Nov,4825(P),4698(P),127(P),2.6(P),"Murray County, MN"
P : Preliminary.,P : Preliminary.,P : Preliminary.,P : Preliminary.,P : Preliminary.,P : Preliminary.,"Murray County, MN"
2014,Jan,19731,18937,794,4.0,"Nicollet County, MN"
2014,Feb,19927,19129,798,4.0,"Nicollet County, MN"
2014,Mar,19868,19090,778,3.9,"Nicollet County, MN"
2014,Apr,19758,19141,617,3.1,"Nicollet County, MN"
2014,May,19745,19160,585,3.0,"Nicollet County, MN"
2014,Jun,19753,19082,671,3.4,"Nicollet County, MN"
2014,Jul,19561,18914,647,3.3,"Nicollet County, MN"
2014,Aug,19385,18805,580,3.0,"Nicollet County, MN"
2014,Sep,19731,19206,525,2.7,"Nicollet County, MN"
2014,Oct,20227,19756,471,2.3,"Nicollet County, MN"
2014,Nov,20040,19604,436,2.2,"Nicollet County, MN"
2014,Dec,19983,19450,533,2.7,"Nicollet County, MN"
2015,Jan,19997,19323,674,3.4,"Nicollet County, MN"
2015,Feb,20138,19504,634,3.1,"Nicollet County, MN"
2015,Mar,20208,19586,622,3.1,"Nicollet County, MN"
2015,Apr,20544,20040,504,2.5,"Nicollet County, MN"
2015,May,20373,19827,546,2.7,"Nicollet County, MN"
2015,Jun,20063,19451,612,3.1,"Nicollet County, MN"
2015,Jul,19821,19256,565,2.9,"Nicollet County, MN"
2015,Aug,19831,19311,520,2.6,"Nicollet County, MN"
2015,Sep,20354,19879,475,2.3,"Nicollet County, MN"
2015,Oct,21141,20666,475,2.2,"Nicollet County, MN"
2015,Nov,20965,20532,433,2.1,"Nicollet County, MN"
2015,Dec,20755,20237,518,2.5,"Nicollet County, MN"
2016,Jan,20480,19840,640,3.1,"Nicollet County, MN"
2016,Feb,20659,19994,665,3.2,"Nicollet County, MN"
2016,Mar,20686,20001,685,3.3,"Nicollet County, MN"
2016,Apr,20463,19938,525,2.6,"Nicollet County, MN"
2016,May,20257,19759,498,2.5,"Nicollet County, MN"
2016,Jun,19928,19300,628,3.2,"Nicollet County, MN"
2016,Jul,19711,19144,567,2.9,"Nicollet County, MN"
2016,Aug,19752,19184,568,2.9,"Nicollet County, MN"
2016,Sep,20266,19736,530,2.6,"Nicollet County, MN"
2016,Oct,20886,20370,516,2.5,"Nicollet County, MN"
2016,Nov,20591,20111,480,2.3,"Nicollet County, MN"
2016,Dec,20433,19828,605,3.0,"Nicollet County, MN"
2017,Jan,20521,19819,702,3.4,"Nicollet County, MN"
2017,Feb,20679,19972,707,3.4,"Nicollet County, MN"
2017,Mar,20757,20129,628,3.0,"Nicollet County, MN"
2017,Apr,20868,20374,494,2.4,"Nicollet County, MN"
2017,May,20592,20093,499,2.4,"Nicollet County, MN"
2017,Jun,20582,20000,582,2.8,"Nicollet County, MN"
2017,Jul,20220,19680,540,2.7,"Nicollet County, MN"
2017,Aug,20154,19650,504,2.5,"Nicollet County, MN"
2017,Sep,20851,20398,453,2.2,"Nicollet County, MN"
2017,Oct,21372,20986,386,1.8,"Nicollet County, MN"
2017,Nov,21023,20646,377,1.8,"Nicollet County, MN"
2017,Dec,20863,20373,490,2.3,"Nicollet County, MN"
2018,Jan,20678,20087,591,2.9,"Nicollet County, MN"
2018,Feb,20960,20362,598,2.9,"Nicollet County, MN"
2018,Mar,20937,20370,567,2.7,"Nicollet County, MN"
2018,Apr,20889,20429,460,2.2,"Nicollet County, MN"
2018,May,20818,20424,394,1.9,"Nicollet County, MN"
2018,Jun,20635,20111,524,2.5,"Nicollet County, MN"
2018,Jul,20332,19898,434,2.1,"Nicollet County, MN"
2018,Aug,20047,19621,426,2.1,"Nicollet County, MN"
2018,Sep,20834,20433,401,1.9,"Nicollet County, MN"
2018,Oct,21365,20988,377,1.8,"Nicollet County, MN"
2018,Nov,21074,20705,369,1.8,"Nicollet County, MN"
2018,Dec,21102,20560,542,2.6,"Nicollet County, MN"
2019,Jan,20775,20131,644,3.1,"Nicollet County, MN"
2019,Feb,20942,20312,630,3.0,"Nicollet County, MN"
2019,Mar,20953,20311,642,3.1,"Nicollet County, MN"
2019,Apr,21078,20580,498,2.4,"Nicollet County, MN"
2019,May,21082,20578,504,2.4,"Nicollet County, MN"
2019,Jun,20887,20268,619,3.0,"Nicollet County, MN"
2019,Jul,20557,19981,576,2.8,"Nicollet County, MN"
2019,Aug,20586,20038,548,2.7,"Nicollet County, MN"
2019,Sep,21249,20775,474,2.2,"Nicollet County, MN"
2019,Oct,21732,21309,423,1.9,"Nicollet County, MN"
2019,Nov,21386,20984,402,1.9,"Nicollet County, MN"
2019,Dec,21324,20789,535,2.5,"Nicollet County, MN"
2020,Jan,21000,20407,593,2.8,"Nicollet County, MN"
2020,Feb,21254,20653,601,2.8,"Nicollet County, MN"
2020,Mar,20999,20214,785,3.7,"Nicollet County, MN"
2020,Apr,20145,18729,1416,7.0,"Nicollet County, MN"
2020,May,20201,18420,1781,8.8,"Nicollet County, MN"
2020,Jun,20927,19401,1526,7.3,"Nicollet County, MN"
2020,Jul,20778,19407,1371,6.6,"Nicollet County, MN"
2020,Aug,20829,19755,1074,5.2,"Nicollet County, MN"
2020,Sep,21122,20206,916,4.3,"Nicollet County, MN"
2020,Oct,21883,21141,742,3.4,"Nicollet County, MN"
2020,Nov,21289,20627,662,3.1,"Nicollet County, MN"
2020,Dec,20877,20086,791,3.8,"Nicollet County, MN"
2021,Jan,20610,19727,883,4.3,"Nicollet County, MN"
2021,Feb,20744,19942,802,3.9,"Nicollet County, MN"
2021,Mar,20542,19773,769,3.7,"Nicollet County, MN"
2021,Apr,20488,19843,645,3.1,"Nicollet County, MN"
2021,May,20348,19743,605,3.0,"Nicollet County, MN"
2021,Jun,20185,19456,729,3.6,"Nicollet County, MN"
2021,Jul,19832,19215,617,3.1,"Nicollet County, MN"
2021,Aug,19709,19126,583,3.0,"Nicollet County, MN"
2021,Sep,20197,19700,497,2.5,"Nicollet County, MN"
2021,Oct,20879,20465,414,2.0,"Nicollet County, MN"
2021,Nov,20695,20346,349,1.7,"Nicollet County, MN"
2021,Dec,20698,20256,442,2.1,"Nicollet County, MN"
2022,Jan,20599,20067,532,2.6,"Nicollet County, MN"
2022,Feb,20835,20338,497,2.4,"Nicollet County, MN"
2022,Mar,20797,20320,477,2.3,"Nicollet County, MN"
2022,Apr,20623,20316,307,1.5,"Nicollet County, MN"
2022,May,20389,20078,311,1.5,"Nicollet County, MN"
2022,Jun,20187,19763,424,2.1,"Nicollet County, MN"
2022,Jul,20095,19710,385,1.9,"Nicollet County, MN"
2022,Aug,20193,19800,393,1.9,"Nicollet County, MN"
2022,Sep,20798,20497,301,1.4,"Nicollet County, MN"
2022,Oct,21312,21008,304,1.4,"Nicollet County, MN"
2022,Nov,20979,20643,336,1.6,"Nicollet County, MN"
2022,Dec,21033,20557,476,2.3,"Nicollet County, MN"
2023,Jan,20847,20330,517,2.5,"Nicollet County, MN"
2023,Feb,21129,20572,557,2.6,"Nicollet County, MN"
2023,Mar,21172,20623,549,2.6,"Nicollet County, MN"
2023,Apr,21217,20760,457,2.2,"Nicollet County, MN"
2023,May,20934,20516,418,2.0,"Nicollet County, MN"
2023,Jun,20808,20276,532,2.6,"Nicollet County, MN"
2023,Jul,20817,20308,509,2.4,"Nicollet County, MN"
2023,Aug,20831,20296,535,2.6,"Nicollet County, MN"
2023,Sep,21075,20691,384,1.8,"Nicollet County, MN"
2023,Oct,21367,21002,365,1.7,"Nicollet County, MN"
2023,Nov,21124,20834,290,1.4,"Nicollet County, MN"
2023,Dec,20859,20437,422,2.0,"Nicollet County, MN"
2024,Jan,20984,20413,571,2.7,"Nicollet County, MN"
2024,Feb,21093,20453,640,3.0,"Nicollet County, MN"
2024,Mar,21298,20739,559,2.6,"Nicollet County, MN"
2024,Apr,21263,20812,451,2.1,"Nicollet County, MN"
2024,May,20871,20391,480,2.3,"Nicollet County, MN"
2024,Jun,21106,20402,704,3.3,"Nicollet County, MN"
2024,Jul,21188,20508,680,3.2,"Nicollet County, MN"
2024,Aug,21427,20773,654,3.1,"Nicollet County, MN"
2024,Sep,21830,21361,469,2.1,"Nicollet County, MN"
2024,Oct,22166,21753,413,1.9,"Nicollet County, MN"
2024,Nov,21751(P),21289(P),462(P),2.1(P),"Nicollet County, MN"
P : Preliminary.,P : Preliminary.,P : Preliminary.,P : Preliminary.,P : Preliminary.,P : Preliminary.,"Nicollet County, MN"
2014,Jan,11113,10588,525,4.7,"Nobles County, MN"
2014,Feb,11091,10570,521,4.7,"Nobles County, MN"
2014,Mar,11149,10659,490,4.4,"Nobles County, MN"
2014,Apr,11102,10714,388,3.5,"Nobles County, MN"
2014,May,11103,10755,348,3.1,"Nobles County, MN"
2014,Jun,11234,10822,412,3.7,"Nobles County, MN"
2014,Jul,11305,10904,401,3.5,"Nobles County, MN"
2014,Aug,11195,10860,335,3.0,"Nobles County, MN"
2014,Sep,11297,10986,311,2.8,"Nobles County, MN"
2014,Oct,11527,11184,343,3.0,"Nobles County, MN"
2014,Nov,11448,11157,291,2.5,"Nobles County, MN"
2014,Dec,11500,11139,361,3.1,"Nobles County, MN"
2015,Jan,11573,11116,457,3.9,"Nobles County, MN"
2015,Feb,11422,10964,458,4.0,"Nobles County, MN"
2015,Mar,11658,11215,443,3.8,"Nobles County, MN"
2015,Apr,11465,11118,347,3.0,"Nobles County, MN"
2015,May,11462,11118,344,3.0,"Nobles County, MN"
2015,Jun,11585,11184,401,3.5,"Nobles County, MN"
2015,Jul,11454,11094,360,3.1,"Nobles County, MN"
2015,Aug,11275,10960,315,2.8,"Nobles County, MN"
2015,Sep,11488,11161,327,2.8,"Nobles County, MN"
2015,Oct,11819,11495,324,2.7,"Nobles County, MN"
2015,Nov,11710,11396,314,2.7,"Nobles County, MN"
2015,Dec,11713,11264,449,3.8,"Nobles County, MN"
2016,Jan,11824,11246,578,4.9,"Nobles County, MN"
2016,Feb,11575,11032,543,4.7,"Nobles County, MN"
2016,Mar,11696,11212,484,4.1,"Nobles County, MN"
2016,Apr,11480,11117,363,3.2,"Nobles County, MN"
2016,May,11358,11004,354,3.1,"Nobles County, MN"
2016,Jun,11257,10792,465,4.1,"Nobles County, MN"
2016,Jul,11356,10880,476,4.2,"Nobles County, MN"
2016,Aug,11109,10714,395,3.6,"Nobles County, MN"
2016,Sep,11106,10748,358,3.2,"Nobles County, MN"
2016,Oct,11581,11184,397,3.4,"Nobles County, MN"
2016,Nov,11557,11216,341,3.0,"Nobles County, MN"
2016,Dec,11493,11068,425,3.7,"Nobles County, MN"
2017,Jan,11797,11231,566,4.8,"Nobles County, MN"
2017,Feb,11523,11066,457,4.0,"Nobles County, MN"
2017,Mar,11637,11141,496,4.3,"Nobles County, MN"
2017,Apr,11472,11137,335,2.9,"Nobles County, MN"
2017,May,11370,11056,314,2.8,"Nobles County, MN"
2017,Jun,11317,10959,358,3.2,"Nobles County, MN"
2017,Jul,11210,10873,337,3.0,"Nobles County, MN"
2017,Aug,11129,10755,374,3.4,"Nobles County, MN"
2017,Sep,11176,10855,321,2.9,"Nobles County, MN"
2017,Oct,11378,11120,258,2.3,"Nobles County, MN"
2017,Nov,11356,11102,254,2.2,"Nobles County, MN"
2017,Dec,11343,11030,313,2.8,"Nobles County, MN"
2018,Jan,11295,10863,432,3.8,"Nobles County, MN"
2018,Feb,11276,10893,383,3.4,"Nobles County, MN"
2018,Mar,11281,10911,370,3.3,"Nobles County, MN"
2018,Apr,11351,11061,290,2.6,"Nobles County, MN"
2018,May,11453,11200,253,2.2,"Nobles County, MN"
2018,Jun,11446,11111,335,2.9,"Nobles County, MN"
2018,Jul,11388,11084,304,2.7,"Nobles County, MN"
2018,Aug,10940,10666,274,2.5,"Nobles County, MN"
2018,Sep,11182,10939,243,2.2,"Nobles County, MN"
2018,Oct,11404,11183,221,1.9,"Nobles County, MN"
2018,Nov,11290,11080,210,1.9,"Nobles County, MN"
2018,Dec,11324,10999,325,2.9,"Nobles County, MN"
2019,Jan,11056,10651,405,3.7,"Nobles County, MN"
2019,Feb,10939,10579,360,3.3,"Nobles County, MN"
2019,Mar,10922,10533,389,3.6,"Nobles County, MN"
2019,Apr,11179,10881,298,2.7,"Nobles County, MN"
2019,May,11360,11075,285,2.5,"Nobles County, MN"
2019,Jun,11356,10983,373,3.3,"Nobles County, MN"
2019,Jul,11479,11102,377,3.3,"Nobles County, MN"
2019,Aug,11102,10755,347,3.1,"Nobles County, MN"
2019,Sep,11318,11023,295,2.6,"Nobles County, MN"
2019,Oct,11714,11373,341,2.9,"Nobles County, MN"
2019,Nov,11378,11094,284,2.5,"Nobles County, MN"
2019,Dec,11446,11132,314,2.7,"Nobles County, MN"
2020,Jan,11271,10878,393,3.5,"Nobles County, MN"
2020,Feb,11303,10907,396,3.5,"Nobles County, MN"
2020,Mar,11251,10806,445,4.0,"Nobles County, MN"
2020,Apr,11426,10931,495,4.3,"Nobles County, MN"
2020,May,11287,10520,767,6.8,"Nobles County, MN"
2020,Jun,11932,11204,728,6.1,"Nobles County, MN"
2020,Jul,12070,11466,604,5.0,"Nobles County, MN"
2020,Aug,11746,11269,477,4.1,"Nobles County, MN"
2020,Sep,11814,11376,438,3.7,"Nobles County, MN"
2020,Oct,12223,11727,496,4.1,"Nobles County, MN"
2020,Nov,11850,11495,355,3.0,"Nobles County, MN"
2020,Dec,11781,11392,389,3.3,"Nobles County, MN"
2021,Jan,11563,11104,459,4.0,"Nobles County, MN"
2021,Feb,11428,11010,418,3.7,"Nobles County, MN"
2021,Mar,11291,10870,421,3.7,"Nobles County, MN"
2021,Apr,11275,10931,344,3.1,"Nobles County, MN"
2021,May,11188,10852,336,3.0,"Nobles County, MN"
2021,Jun,11320,10895,425,3.8,"Nobles County, MN"
2021,Jul,11391,10980,411,3.6,"Nobles County, MN"
2021,Aug,11168,10822,346,3.1,"Nobles County, MN"
2021,Sep,11340,11037,303,2.7,"Nobles County, MN"
2021,Oct,11464,11197,267,2.3,"Nobles County, MN"
2021,Nov,11291,11080,211,1.9,"Nobles County, MN"
2021,Dec,11423,11186,237,2.1,"Nobles County, MN"
2022,Jan,11345,11029,316,2.8,"Nobles County, MN"
2022,Feb,11307,11033,274,2.4,"Nobles County, MN"
2022,Mar,11316,11052,264,2.3,"Nobles County, MN"
2022,Apr,10971,10791,180,1.6,"Nobles County, MN"
2022,May,10955,10749,206,1.9,"Nobles County, MN"
2022,Jun,10990,10724,266,2.4,"Nobles County, MN"
2022,Jul,11232,10958,274,2.4,"Nobles County, MN"
2022,Aug,10959,10723,236,2.2,"Nobles County, MN"
2022,Sep,11055,10881,174,1.6,"Nobles County, MN"
2022,Oct,11176,11006,170,1.5,"Nobles County, MN"
2022,Nov,11030,10824,206,1.9,"Nobles County, MN"
2022,Dec,11251,10971,280,2.5,"Nobles County, MN"
2023,Jan,11150,10828,322,2.9,"Nobles County, MN"
2023,Feb,11170,10856,314,2.8,"Nobles County, MN"
2023,Mar,11135,10825,310,2.8,"Nobles County, MN"
2023,Apr,11060,10809,251,2.3,"Nobles County, MN"
2023,May,10913,10686,227,2.1,"Nobles County, MN"
2023,Jun,10984,10546,438,4.0,"Nobles County, MN"
2023,Jul,11042,10573,469,4.2,"Nobles County, MN"
2023,Aug,11184,10773,411,3.7,"Nobles County, MN"
2023,Sep,11144,10848,296,2.7,"Nobles County, MN"
2023,Oct,11224,10984,240,2.1,"Nobles County, MN"
2023,Nov,11153,10988,165,1.5,"Nobles County, MN"
2023,Dec,10944,10742,202,1.8,"Nobles County, MN"
2024,Jan,10935,10666,269,2.5,"Nobles County, MN"
2024,Feb,10898,10598,300,2.8,"Nobles County, MN"
2024,Mar,11058,10813,245,2.2,"Nobles County, MN"
2024,Apr,11069,10854,215,1.9,"Nobles County, MN"
2024,May,10747,10529,218,2.0,"Nobles County, MN"
2024,Jun,11090,10627,463,4.2,"Nobles County, MN"
2024,Jul,11280,10749,531,4.7,"Nobles County, MN"
2024,Aug,11426,11000,426,3.7,"Nobles County, MN"
2024,Sep,11455,11173,282,2.5,"Nobles County, MN"
2024,Oct,11366,11116,250,2.2,"Nobles County, MN"
2024,Nov,11337(P),11095(P),242(P),2.1(P),"Nobles County, MN"
P : Preliminary.,P : Preliminary.,P : Preliminary.,P : Preliminary.,P : Preliminary.,P : Preliminary.,"Nobles County, MN"
2014,Jan,3245,3013,232,7.1,"Norman County, MN"
2014,Feb,3246,3018,228,7.0,"Norman County, MN"
2014,Mar,3262,3039,223,6.8,"Norman County, MN"
2014,Apr,3235,3058,177,5.5,"Norman County, MN"
2014,May,3263,3112,151,4.6,"Norman County, MN"
2014,Jun,3344,3185,159,4.8,"Norman County, MN"
2014,Jul,3438,3270,168,4.9,"Norman County, MN"
2014,Aug,3355,3217,138,4.1,"Norman County, MN"
2014,Sep,3314,3182,132,4.0,"Norman County, MN"
2014,Oct,3384,3269,115,3.4,"Norman County, MN"
2014,Nov,3370,3232,138,4.1,"Norman County, MN"
2014,Dec,3424,3242,182,5.3,"Norman County, MN"
2015,Jan,3459,3238,221,6.4,"Norman County, MN"
2015,Feb,3392,3173,219,6.5,"Norman County, MN"
2015,Mar,3475,3256,219,6.3,"Norman County, MN"
2015,Apr,3411,3258,153,4.5,"Norman County, MN"
2015,May,3394,3243,151,4.4,"Norman County, MN"
2015,Jun,3508,3342,166,4.7,"Norman County, MN"
2015,Jul,3418,3256,162,4.7,"Norman County, MN"
2015,Aug,3335,3198,137,4.1,"Norman County, MN"
2015,Sep,3304,3188,116,3.5,"Norman County, MN"
2015,Oct,3585,3474,111,3.1,"Norman County, MN"
2015,Nov,3504,3378,126,3.6,"Norman County, MN"
2015,Dec,3615,3423,192,5.3,"Norman County, MN"
2016,Jan,3580,3358,222,6.2,"Norman County, MN"
2016,Feb,3428,3215,213,6.2,"Norman County, MN"
2016,Mar,3540,3322,218,6.2,"Norman County, MN"
2016,Apr,3404,3247,157,4.6,"Norman County, MN"
2016,May,3406,3274,132,3.9,"Norman County, MN"
2016,Jun,3446,3276,170,4.9,"Norman County, MN"
2016,Jul,3370,3210,160,4.7,"Norman County, MN"
2016,Aug,3308,3166,142,4.3,"Norman County, MN"
2016,Sep,3291,3162,129,3.9,"Norman County, MN"
2016,Oct,3466,3346,120,3.5,"Norman County, MN"
2016,Nov,3476,3355,121,3.5,"Norman County, MN"
2016,Dec,3558,3372,186,5.2,"Norman County, MN"
2017,Jan,3556,3321,235,6.6,"Norman County, MN"
2017,Feb,3447,3219,228,6.6,"Norman County, MN"
2017,Mar,3481,3264,217,6.2,"Norman County, MN"
2017,Apr,3457,3288,169,4.9,"Norman County, MN"
2017,May,3460,3324,136,3.9,"Norman County, MN"
2017,Jun,3472,3312,160,4.6,"Norman County, MN"
2017,Jul,3351,3198,153,4.6,"Norman County, MN"
2017,Aug,3249,3109,140,4.3,"Norman County, MN"
2017,Sep,3225,3123,102,3.2,"Norman County, MN"
2017,Oct,3405,3313,92,2.7,"Norman County, MN"
2017,Nov,3380,3245,135,4.0,"Norman County, MN"
2017,Dec,3459,3288,171,4.9,"Norman County, MN"
2018,Jan,3329,3121,208,6.2,"Norman County, MN"
2018,Feb,3342,3152,190,5.7,"Norman County, MN"
2018,Mar,3370,3182,188,5.6,"Norman County, MN"
2018,Apr,3417,3268,149,4.4,"Norman County, MN"
2018,May,3452,3336,116,3.4,"Norman County, MN"
2018,Jun,3475,3331,144,4.1,"Norman County, MN"
2018,Jul,3479,3319,160,4.6,"Norman County, MN"
2018,Aug,3227,3100,127,3.9,"Norman County, MN"
2018,Sep,3258,3151,107,3.3,"Norman County, MN"
2018,Oct,3367,3266,101,3.0,"Norman County, MN"
2018,Nov,3256,3144,112,3.4,"Norman County, MN"
2018,Dec,3370,3182,188,5.6,"Norman County, MN"
2019,Jan,3217,2981,236,7.3,"Norman County, MN"
2019,Feb,3210,2987,223,6.9,"Norman County, MN"
2019,Mar,3233,3019,214,6.6,"Norman County, MN"
2019,Apr,3273,3104,169,5.2,"Norman County, MN"
2019,May,3345,3217,128,3.8,"Norman County, MN"
2019,Jun,3383,3211,172,5.1,"Norman County, MN"
2019,Jul,3371,3201,170,5.0,"Norman County, MN"
2019,Aug,3176,3049,127,4.0,"Norman County, MN"
2019,Sep,3176,3086,90,2.8,"Norman County, MN"
2019,Oct,3332,3246,86,2.6,"Norman County, MN"
2019,Nov,3213,3097,116,3.6,"Norman County, MN"
2019,Dec,3308,3130,178,5.4,"Norman County, MN"
2020,Jan,3179,2951,228,7.2,"Norman County, MN"
2020,Feb,3155,2958,197,6.2,"Norman County, MN"
2020,Mar,3176,2926,250,7.9,"Norman County, MN"
2020,Apr,3276,2987,289,8.8,"Norman County, MN"
2020,May,3300,2998,302,9.2,"Norman County, MN"
2020,Jun,3428,3166,262,7.6,"Norman County, MN"
2020,Jul,3531,3296,235,6.7,"Norman County, MN"
2020,Aug,3361,3188,173,5.1,"Norman County, MN"
2020,Sep,3307,3147,160,4.8,"Norman County, MN"
2020,Oct,3493,3351,142,4.1,"Norman County, MN"
2020,Nov,3326,3184,142,4.3,"Norman County, MN"
2020,Dec,3391,3216,175,5.2,"Norman County, MN"
2021,Jan,3236,3039,197,6.1,"Norman County, MN"
2021,Feb,3200,3015,185,5.8,"Norman County, MN"
2021,Mar,3130,2952,178,5.7,"Norman County, MN"
2021,Apr,3140,2978,162,5.2,"Norman County, MN"
2021,May,3153,3026,127,4.0,"Norman County, MN"
2021,Jun,3206,3056,150,4.7,"Norman County, MN"
2021,Jul,3291,3151,140,4.3,"Norman County, MN"
2021,Aug,3201,3088,113,3.5,"Norman County, MN"
2021,Sep,3116,3026,90,2.9,"Norman County, MN"
2021,Oct,3217,3148,69,2.1,"Norman County, MN"
2021,Nov,3169,3081,88,2.8,"Norman County, MN"
2021,Dec,3316,3193,123,3.7,"Norman County, MN"
2022,Jan,3218,3060,158,4.9,"Norman County, MN"
2022,Feb,3218,3070,148,4.6,"Norman County, MN"
2022,Mar,3191,3054,137,4.3,"Norman County, MN"
2022,Apr,3082,2985,97,3.1,"Norman County, MN"
2022,May,3085,3006,79,2.6,"Norman County, MN"
2022,Jun,3190,3087,103,3.2,"Norman County, MN"
2022,Jul,3263,3155,108,3.3,"Norman County, MN"
2022,Aug,3170,3077,93,2.9,"Norman County, MN"
2022,Sep,3101,3029,72,2.3,"Norman County, MN"
2022,Oct,3193,3119,74,2.3,"Norman County, MN"
2022,Nov,3138,3050,88,2.8,"Norman County, MN"
2022,Dec,3269,3137,132,4.0,"Norman County, MN"
2023,Jan,3202,3048,154,4.8,"Norman County, MN"
2023,Feb,3237,3078,159,4.9,"Norman County, MN"
2023,Mar,3222,3069,153,4.7,"Norman County, MN"
2023,Apr,3134,3019,115,3.7,"Norman County, MN"
2023,May,3137,3049,88,2.8,"Norman County, MN"
2023,Jun,3180,3046,134,4.2,"Norman County, MN"
2023,Jul,3152,3015,137,4.3,"Norman County, MN"
2023,Aug,3228,3109,119,3.7,"Norman County, MN"
2023,Sep,3176,3108,68,2.1,"Norman County, MN"
2023,Oct,3235,3175,60,1.9,"Norman County, MN"
2023,Nov,3219,3155,64,2.0,"Norman County, MN"
2023,Dec,3187,3083,104,3.3,"Norman County, MN"
2024,Jan,3159,3002,157,5.0,"Norman County, MN"
2024,Feb,3152,2988,164,5.2,"Norman County, MN"
2024,Mar,3233,3092,141,4.4,"Norman County, MN"
2024,Apr,3204,3102,102,3.2,"Norman County, MN"
2024,May,3104,3004,100,3.2,"Norman County, MN"
2024,Jun,3277,3129,148,4.5,"Norman County, MN"
2024,Jul,3317,3164,153,4.6,"Norman County, MN"
2024,Aug,3422,3296,126,3.7,"Norman County, MN"
2024,Sep,3356,3273,83,2.5,"Norman County, MN"
2024,Oct,3330,3264,66,2.0,"Norman County, MN"
2024,Nov,3353(P),3255(P),98(P),2.9(P),"Norman County, MN"
P : Preliminary.,P : Preliminary.,P : Preliminary.,P : Preliminary.,P : Preliminary.,P : Preliminary.,"Norman County, MN"
2014,Jan,82604,78983,3621,4.4,"Olmsted County, MN"
2014,Feb,82336,78655,3681,4.5,"Olmsted County, MN"
2014,Mar,82866,79210,3656,4.4,"Olmsted County, MN"
2014,Apr,82914,79886,3028,3.7,"Olmsted County, MN"
2014,May,83193,80356,2837,3.4,"Olmsted County, MN"
2014,Jun,84460,81387,3073,3.6,"Olmsted County, MN"
2014,Jul,85011,82039,2972,3.5,"Olmsted County, MN"
2014,Aug,84589,81842,2747,3.2,"Olmsted County, MN"
2014,Sep,82997,80545,2452,3.0,"Olmsted County, MN"
2014,Oct,83008,80694,2314,2.8,"Olmsted County, MN"
2014,Nov,82512,80190,2322,2.8,"Olmsted County, MN"
2014,Dec,82220,79623,2597,3.2,"Olmsted County, MN"
2015,Jan,82499,79355,3144,3.8,"Olmsted County, MN"
2015,Feb,82525,79464,3061,3.7,"Olmsted County, MN"
2015,Mar,82770,79702,3068,3.7,"Olmsted County, MN"
2015,Apr,83393,80952,2441,2.9,"Olmsted County, MN"
2015,May,84249,81756,2493,3.0,"Olmsted County, MN"
2015,Jun,85079,82387,2692,3.2,"Olmsted County, MN"
2015,Jul,85954,83408,2546,3.0,"Olmsted County, MN"
2015,Aug,85670,83359,2311,2.7,"Olmsted County, MN"
2015,Sep,84377,82280,2097,2.5,"Olmsted County, MN"
2015,Oct,84034,82031,2003,2.4,"Olmsted County, MN"
2015,Nov,84409,82470,1939,2.3,"Olmsted County, MN"
2015,Dec,84004,81716,2288,2.7,"Olmsted County, MN"
2016,Jan,84413,81590,2823,3.3,"Olmsted County, MN"
2016,Feb,84745,81891,2854,3.4,"Olmsted County, MN"
2016,Mar,85268,82377,2891,3.4,"Olmsted County, MN"
2016,Apr,84722,82388,2334,2.8,"Olmsted County, MN"
2016,May,84982,82794,2188,2.6,"Olmsted County, MN"
2016,Jun,85894,83208,2686,3.1,"Olmsted County, MN"
2016,Jul,86758,84195,2563,3.0,"Olmsted County, MN"
2016,Aug,86339,83790,2549,3.0,"Olmsted County, MN"
2016,Sep,85110,82704,2406,2.8,"Olmsted County, MN"
2016,Oct,84887,82543,2344,2.8,"Olmsted County, MN"
2016,Nov,84497,82309,2188,2.6,"Olmsted County, MN"
2016,Dec,84334,81744,2590,3.1,"Olmsted County, MN"
2017,Jan,85201,82186,3015,3.5,"Olmsted County, MN"
2017,Feb,85746,82835,2911,3.4,"Olmsted County, MN"
2017,Mar,86156,83456,2700,3.1,"Olmsted County, MN"
2017,Apr,86510,84179,2331,2.7,"Olmsted County, MN"
2017,May,86884,84605,2279,2.6,"Olmsted County, MN"
2017,Jun,88758,86158,2600,2.9,"Olmsted County, MN"
2017,Jul,89341,86968,2373,2.7,"Olmsted County, MN"
2017,Aug,88722,86443,2279,2.6,"Olmsted County, MN"
2017,Sep,87702,85699,2003,2.3,"Olmsted County, MN"
2017,Oct,86662,84837,1825,2.1,"Olmsted County, MN"
2017,Nov,86729,84825,1904,2.2,"Olmsted County, MN"
2017,Dec,86817,84548,2269,2.6,"Olmsted County, MN"
2018,Jan,86608,84022,2586,3.0,"Olmsted County, MN"
2018,Feb,87164,84578,2586,3.0,"Olmsted County, MN"
2018,Mar,87634,85097,2537,2.9,"Olmsted County, MN"
2018,Apr,87221,85185,2036,2.3,"Olmsted County, MN"
2018,May,87420,85671,1749,2.0,"Olmsted County, MN"
2018,Jun,88851,86597,2254,2.5,"Olmsted County, MN"
2018,Jul,89442,87515,1927,2.2,"Olmsted County, MN"
2018,Aug,88967,87050,1917,2.2,"Olmsted County, MN"
2018,Sep,87881,86165,1716,2.0,"Olmsted County, MN"
2018,Oct,87574,85906,1668,1.9,"Olmsted County, MN"
2018,Nov,87551,85867,1684,1.9,"Olmsted County, MN"
2018,Dec,87827,85510,2317,2.6,"Olmsted County, MN"
2019,Jan,88823,86165,2658,3.0,"Olmsted County, MN"
2019,Feb,88654,86091,2563,2.9,"Olmsted County, MN"
2019,Mar,89059,86328,2731,3.1,"Olmsted County, MN"
2019,Apr,88402,86234,2168,2.5,"Olmsted County, MN"
2019,May,88812,86574,2238,2.5,"Olmsted County, MN"
2019,Jun,90118,87420,2698,3.0,"Olmsted County, MN"
2019,Jul,91126,88628,2498,2.7,"Olmsted County, MN"
2019,Aug,90950,88586,2364,2.6,"Olmsted County, MN"
2019,Sep,89801,87834,1967,2.2,"Olmsted County, MN"
2019,Oct,89682,87762,1920,2.1,"Olmsted County, MN"
2019,Nov,89658,87767,1891,2.1,"Olmsted County, MN"
2019,Dec,90443,88158,2285,2.5,"Olmsted County, MN"
2020,Jan,90458,88013,2445,2.7,"Olmsted County, MN"
2020,Feb,90682,88158,2524,2.8,"Olmsted County, MN"
2020,Mar,90986,87607,3379,3.7,"Olmsted County, MN"
2020,Apr,88486,82508,5978,6.8,"Olmsted County, MN"
2020,May,91726,81274,10452,11.4,"Olmsted County, MN"
2020,Jun,92503,84118,8385,9.1,"Olmsted County, MN"
2020,Jul,94710,87736,6974,7.4,"Olmsted County, MN"
2020,Aug,94609,89585,5024,5.3,"Olmsted County, MN"
2020,Sep,93090,88819,4271,4.6,"Olmsted County, MN"
2020,Oct,92999,89005,3994,4.3,"Olmsted County, MN"
2020,Nov,91562,88344,3218,3.5,"Olmsted County, MN"
2020,Dec,90439,86799,3640,4.0,"Olmsted County, MN"
2021,Jan,90386,86548,3838,4.2,"Olmsted County, MN"
2021,Feb,90463,86869,3594,4.0,"Olmsted County, MN"
2021,Mar,90617,87223,3394,3.7,"Olmsted County, MN"
2021,Apr,90924,88038,2886,3.2,"Olmsted County, MN"
2021,May,90990,88271,2719,3.0,"Olmsted County, MN"
2021,Jun,91749,88487,3262,3.6,"Olmsted County, MN"
2021,Jul,92319,89581,2738,3.0,"Olmsted County, MN"
2021,Aug,91876,89179,2697,2.9,"Olmsted County, MN"
2021,Sep,90953,88577,2376,2.6,"Olmsted County, MN"
2021,Oct,90050,87996,2054,2.3,"Olmsted County, MN"
2021,Nov,90209,88406,1803,2.0,"Olmsted County, MN"
2021,Dec,90419,88368,2051,2.3,"Olmsted County, MN"
2022,Jan,90517,87980,2537,2.8,"Olmsted County, MN"
2022,Feb,90184,87981,2203,2.4,"Olmsted County, MN"
2022,Mar,90801,88656,2145,2.4,"Olmsted County, MN"
2022,Apr,90407,88898,1509,1.7,"Olmsted County, MN"
2022,May,90806,89265,1541,1.7,"Olmsted County, MN"
2022,Jun,91837,89733,2104,2.3,"Olmsted County, MN"
2022,Jul,92414,90530,1884,2.0,"Olmsted County, MN"
2022,Aug,92339,90365,1974,2.1,"Olmsted County, MN"
2022,Sep,91286,89660,1626,1.8,"Olmsted County, MN"
2022,Oct,90380,88808,1572,1.7,"Olmsted County, MN"
2022,Nov,90217,88628,1589,1.8,"Olmsted County, MN"
2022,Dec,90461,88429,2032,2.2,"Olmsted County, MN"
2023,Jan,90364,88122,2242,2.5,"Olmsted County, MN"
2023,Feb,90838,88521,2317,2.6,"Olmsted County, MN"
2023,Mar,91672,89426,2246,2.5,"Olmsted County, MN"
2023,Apr,91508,89647,1861,2.0,"Olmsted County, MN"
2023,May,91703,89811,1892,2.1,"Olmsted County, MN"
2023,Jun,93294,90936,2358,2.5,"Olmsted County, MN"
2023,Jul,93738,91541,2197,2.3,"Olmsted County, MN"
2023,Aug,92810,90561,2249,2.4,"Olmsted County, MN"
2023,Sep,91477,89758,1719,1.9,"Olmsted County, MN"
2023,Oct,91457,89869,1588,1.7,"Olmsted County, MN"
2023,Nov,91470,90212,1258,1.4,"Olmsted County, MN"
2023,Dec,91965,90327,1638,1.8,"Olmsted County, MN"
2024,Jan,92905,90754,2151,2.3,"Olmsted County, MN"
2024,Feb,93274,90829,2445,2.6,"Olmsted County, MN"
2024,Mar,93408,91384,2024,2.2,"Olmsted County, MN"
2024,Apr,93521,91718,1803,1.9,"Olmsted County, MN"
2024,May,93417,91591,1826,2.0,"Olmsted County, MN"
2024,Jun,94524,91842,2682,2.8,"Olmsted County, MN"
2024,Jul,96020,93225,2795,2.9,"Olmsted County, MN"
2024,Aug,96253,93463,2790,2.9,"Olmsted County, MN"
2024,Sep,96052,93915,2137,2.2,"Olmsted County, MN"
2024,Oct,96292,94343,1949,2.0,"Olmsted County, MN"
2024,Nov,96641(P),94489(P),2152(P),2.2(P),"Olmsted County, MN"
P : Preliminary.,P : Preliminary.,P : Preliminary.,P : Preliminary.,P : Preliminary.,P : Preliminary.,"Olmsted County, MN"
2014,Jan,30150,28119,2031,6.7,"Otter Tail County, MN"
2014,Feb,30104,28101,2003,6.7,"Otter Tail County, MN"
2014,Mar,30324,28352,1972,6.5,"Otter Tail County, MN"
2014,Apr,30475,28940,1535,5.0,"Otter Tail County, MN"
2014,May,31283,30069,1214,3.9,"Otter Tail County, MN"
2014,Jun,32013,30707,1306,4.1,"Otter Tail County, MN"
2014,Jul,32273,31020,1253,3.9,"Otter Tail County, MN"
2014,Aug,31730,30580,1150,3.6,"Otter Tail County, MN"
2014,Sep,30959,29917,1042,3.4,"Otter Tail County, MN"
2014,Oct,30790,29814,976,3.2,"Otter Tail County, MN"
2014,Nov,30597,29406,1191,3.9,"Otter Tail County, MN"
2014,Dec,30766,29178,1588,5.2,"Otter Tail County, MN"
2015,Jan,30756,28830,1926,6.3,"Otter Tail County, MN"
2015,Feb,30410,28563,1847,6.1,"Otter Tail County, MN"
2015,Mar,30953,29169,1784,5.8,"Otter Tail County, MN"
2015,Apr,30904,29684,1220,3.9,"Otter Tail County, MN"
2015,May,31521,30363,1158,3.7,"Otter Tail County, MN"
2015,Jun,32162,30929,1233,3.8,"Otter Tail County, MN"
2015,Jul,32062,30907,1155,3.6,"Otter Tail County, MN"
2015,Aug,31438,30401,1037,3.3,"Otter Tail County, MN"
2015,Sep,30820,29853,967,3.1,"Otter Tail County, MN"
2015,Oct,31216,30273,943,3.0,"Otter Tail County, MN"
2015,Nov,30925,29762,1163,3.8,"Otter Tail County, MN"
2015,Dec,31164,29538,1626,5.2,"Otter Tail County, MN"
2016,Jan,31044,29139,1905,6.1,"Otter Tail County, MN"
2016,Feb,30768,28892,1876,6.1,"Otter Tail County, MN"
2016,Mar,31191,29271,1920,6.2,"Otter Tail County, MN"
2016,Apr,30958,29682,1276,4.1,"Otter Tail County, MN"
2016,May,31462,30415,1047,3.3,"Otter Tail County, MN"
2016,Jun,32134,30904,1230,3.8,"Otter Tail County, MN"
2016,Jul,31995,30849,1146,3.6,"Otter Tail County, MN"
2016,Aug,31560,30449,1111,3.5,"Otter Tail County, MN"
2016,Sep,30905,29872,1033,3.3,"Otter Tail County, MN"
2016,Oct,31039,30024,1015,3.3,"Otter Tail County, MN"
2016,Nov,31008,29862,1146,3.7,"Otter Tail County, MN"
2016,Dec,31238,29598,1640,5.3,"Otter Tail County, MN"
2017,Jan,31420,29356,2064,6.6,"Otter Tail County, MN"
2017,Feb,31317,29382,1935,6.2,"Otter Tail County, MN"
2017,Mar,31667,29869,1798,5.7,"Otter Tail County, MN"
2017,Apr,31565,30289,1276,4.0,"Otter Tail County, MN"
2017,May,31986,30986,1000,3.1,"Otter Tail County, MN"
2017,Jun,32765,31683,1082,3.3,"Otter Tail County, MN"
2017,Jul,32508,31547,961,3.0,"Otter Tail County, MN"
2017,Aug,31810,30870,940,3.0,"Otter Tail County, MN"
2017,Sep,31411,30612,799,2.5,"Otter Tail County, MN"
2017,Oct,31272,30543,729,2.3,"Otter Tail County, MN"
2017,Nov,31142,30028,1114,3.6,"Otter Tail County, MN"
2017,Dec,31329,29789,1540,4.9,"Otter Tail County, MN"
2018,Jan,30625,28833,1792,5.9,"Otter Tail County, MN"
2018,Feb,30840,29164,1676,5.4,"Otter Tail County, MN"
2018,Mar,30833,29204,1629,5.3,"Otter Tail County, MN"
2018,Apr,31287,30054,1233,3.9,"Otter Tail County, MN"
2018,May,31982,31163,819,2.6,"Otter Tail County, MN"
2018,Jun,32606,31645,961,2.9,"Otter Tail County, MN"
2018,Jul,32663,31789,874,2.7,"Otter Tail County, MN"
2018,Aug,31471,30651,820,2.6,"Otter Tail County, MN"
2018,Sep,31162,30437,725,2.3,"Otter Tail County, MN"
2018,Oct,31031,30263,768,2.5,"Otter Tail County, MN"
2018,Nov,30821,29841,980,3.2,"Otter Tail County, MN"
2018,Dec,31418,29716,1702,5.4,"Otter Tail County, MN"
2019,Jan,30840,28756,2084,6.8,"Otter Tail County, MN"
2019,Feb,30592,28762,1830,6.0,"Otter Tail County, MN"
2019,Mar,30714,28956,1758,5.7,"Otter Tail County, MN"
2019,Apr,31097,29787,1310,4.2,"Otter Tail County, MN"
2019,May,31957,30979,978,3.1,"Otter Tail County, MN"
2019,Jun,32752,31608,1144,3.5,"Otter Tail County, MN"
2019,Jul,33252,31921,1331,4.0,"Otter Tail County, MN"
2019,Aug,32200,31151,1049,3.3,"Otter Tail County, MN"
2019,Sep,31605,30782,823,2.6,"Otter Tail County, MN"
2019,Oct,31390,30516,874,2.8,"Otter Tail County, MN"
2019,Nov,31035,29946,1089,3.5,"Otter Tail County, MN"
2019,Dec,31430,29712,1718,5.5,"Otter Tail County, MN"
2020,Jan,30876,28861,2015,6.5,"Otter Tail County, MN"
2020,Feb,30859,29012,1847,6.0,"Otter Tail County, MN"
2020,Mar,30894,28741,2153,7.0,"Otter Tail County, MN"
2020,Apr,30060,27639,2421,8.1,"Otter Tail County, MN"
2020,May,30945,28622,2323,7.5,"Otter Tail County, MN"
2020,Jun,33037,30997,2040,6.2,"Otter Tail County, MN"
2020,Jul,33572,31876,1696,5.1,"Otter Tail County, MN"
2020,Aug,32997,31702,1295,3.9,"Otter Tail County, MN"
2020,Sep,32214,31041,1173,3.6,"Otter Tail County, MN"
2020,Oct,32273,31194,1079,3.3,"Otter Tail County, MN"
2020,Nov,31513,30363,1150,3.6,"Otter Tail County, MN"
2020,Dec,31259,29601,1658,5.3,"Otter Tail County, MN"
2021,Jan,30849,28862,1987,6.4,"Otter Tail County, MN"
2021,Feb,30867,29085,1782,5.8,"Otter Tail County, MN"
2021,Mar,30708,29085,1623,5.3,"Otter Tail County, MN"
2021,Apr,31017,29872,1145,3.7,"Otter Tail County, MN"
2021,May,31572,30646,926,2.9,"Otter Tail County, MN"
2021,Jun,32180,31056,1124,3.5,"Otter Tail County, MN"
2021,Jul,32505,31566,939,2.9,"Otter Tail County, MN"
2021,Aug,32111,31203,908,2.8,"Otter Tail County, MN"
2021,Sep,31588,30841,747,2.4,"Otter Tail County, MN"
2021,Oct,31337,30682,655,2.1,"Otter Tail County, MN"
2021,Nov,31009,30312,697,2.2,"Otter Tail County, MN"
2021,Dec,31464,30346,1118,3.6,"Otter Tail County, MN"
2022,Jan,30756,29325,1431,4.7,"Otter Tail County, MN"
2022,Feb,30751,29420,1331,4.3,"Otter Tail County, MN"
2022,Mar,30895,29678,1217,3.9,"Otter Tail County, MN"
2022,Apr,30919,30047,872,2.8,"Otter Tail County, MN"
2022,May,31463,30818,645,2.1,"Otter Tail County, MN"
2022,Jun,32426,31630,796,2.5,"Otter Tail County, MN"
2022,Jul,32434,31715,719,2.2,"Otter Tail County, MN"
2022,Aug,32191,31474,717,2.2,"Otter Tail County, MN"
2022,Sep,31386,30840,546,1.7,"Otter Tail County, MN"
2022,Oct,31271,30703,568,1.8,"Otter Tail County, MN"
2022,Nov,30947,30210,737,2.4,"Otter Tail County, MN"
2022,Dec,31625,30401,1224,3.9,"Otter Tail County, MN"
2023,Jan,30929,29400,1529,4.9,"Otter Tail County, MN"
2023,Feb,31107,29555,1552,5.0,"Otter Tail County, MN"
2023,Mar,31090,29688,1402,4.5,"Otter Tail County, MN"
2023,Apr,31135,29976,1159,3.7,"Otter Tail County, MN"
2023,May,31711,30899,812,2.6,"Otter Tail County, MN"
2023,Jun,32752,31752,1000,3.1,"Otter Tail County, MN"
2023,Jul,32538,31529,1009,3.1,"Otter Tail County, MN"
2023,Aug,32491,31559,932,2.9,"Otter Tail County, MN"
2023,Sep,31684,31028,656,2.1,"Otter Tail County, MN"
2023,Oct,31373,30741,632,2.0,"Otter Tail County, MN"
2023,Nov,31138,30465,673,2.2,"Otter Tail County, MN"
2023,Dec,31107,30026,1081,3.5,"Otter Tail County, MN"
2024,Jan,30657,29226,1431,4.7,"Otter Tail County, MN"
2024,Feb,30723,29214,1509,4.9,"Otter Tail County, MN"
2024,Mar,31103,29769,1334,4.3,"Otter Tail County, MN"
2024,Apr,31235,30268,967,3.1,"Otter Tail County, MN"
2024,May,31510,30508,1002,3.2,"Otter Tail County, MN"
2024,Jun,32469,31231,1238,3.8,"Otter Tail County, MN"
2024,Jul,32582,31378,1204,3.7,"Otter Tail County, MN"
2024,Aug,32823,31637,1186,3.6,"Otter Tail County, MN"
2024,Sep,32082,31249,833,2.6,"Otter Tail County, MN"
2024,Oct,31720,30948,772,2.4,"Otter Tail County, MN"
2024,Nov,31552(P),30582(P),970(P),3.1(P),"Otter Tail County, MN"
P : Preliminary.,P : Preliminary.,P : Preliminary.,P : Preliminary.,P : Preliminary.,P : Preliminary.,"Otter Tail County, MN"
2014,Jan,8695,7924,771,8.9,"Pennington County, MN"
2014,Feb,8705,8030,675,7.8,"Pennington County, MN"
2014,Mar,8819,8042,777,8.8,"Pennington County, MN"
2014,Apr,8835,8280,555,6.3,"Pennington County, MN"
2014,May,8855,8499,356,4.0,"Pennington County, MN"
2014,Jun,8990,8632,358,4.0,"Pennington County, MN"
2014,Jul,8779,8408,371,4.2,"Pennington County, MN"
2014,Aug,8829,8515,314,3.6,"Pennington County, MN"
2014,Sep,8897,8629,268,3.0,"Pennington County, MN"
2014,Oct,8984,8734,250,2.8,"Pennington County, MN"
2014,Nov,8938,8652,286,3.2,"Pennington County, MN"
2014,Dec,9056,8442,614,6.8,"Pennington County, MN"
2015,Jan,9129,8419,710,7.8,"Pennington County, MN"
2015,Feb,9160,8552,608,6.6,"Pennington County, MN"
2015,Mar,9255,8621,634,6.9,"Pennington County, MN"
2015,Apr,9248,8602,646,7.0,"Pennington County, MN"
2015,May,9204,8822,382,4.2,"Pennington County, MN"
2015,Jun,9261,8806,455,4.9,"Pennington County, MN"
2015,Jul,8915,8562,353,4.0,"Pennington County, MN"
2015,Aug,8917,8601,316,3.5,"Pennington County, MN"
2015,Sep,8962,8677,285,3.2,"Pennington County, MN"
2015,Oct,9025,8749,276,3.1,"Pennington County, MN"
2015,Nov,9015,8689,326,3.6,"Pennington County, MN"
2015,Dec,9130,8408,722,7.9,"Pennington County, MN"
2016,Jan,9210,8483,727,7.9,"Pennington County, MN"
2016,Feb,9156,8538,618,6.7,"Pennington County, MN"
2016,Mar,9264,8490,774,8.4,"Pennington County, MN"
2016,Apr,9123,8412,711,7.8,"Pennington County, MN"
2016,May,8993,8628,365,4.1,"Pennington County, MN"
2016,Jun,9078,8707,371,4.1,"Pennington County, MN"
2016,Jul,8967,8590,377,4.2,"Pennington County, MN"
2016,Aug,8879,8511,368,4.1,"Pennington County, MN"
2016,Sep,8839,8524,315,3.6,"Pennington County, MN"
2016,Oct,8935,8615,320,3.6,"Pennington County, MN"
2016,Nov,8984,8573,411,4.6,"Pennington County, MN"
2016,Dec,9035,8144,891,9.9,"Pennington County, MN"
2017,Jan,9137,8263,874,9.6,"Pennington County, MN"
2017,Feb,9061,8263,798,8.8,"Pennington County, MN"
2017,Mar,9195,8390,805,8.8,"Pennington County, MN"
2017,Apr,9055,8241,814,9.0,"Pennington County, MN"
2017,May,8852,8498,354,4.0,"Pennington County, MN"
2017,Jun,8864,8519,345,3.9,"Pennington County, MN"
2017,Jul,8585,8267,318,3.7,"Pennington County, MN"
2017,Aug,8568,8231,337,3.9,"Pennington County, MN"
2017,Sep,8605,8360,245,2.8,"Pennington County, MN"
2017,Oct,8630,8410,220,2.5,"Pennington County, MN"
2017,Nov,8625,8314,311,3.6,"Pennington County, MN"
2017,Dec,8868,8244,624,7.0,"Pennington County, MN"
2018,Jan,8888,8185,703,7.9,"Pennington County, MN"
2018,Feb,8848,8216,632,7.1,"Pennington County, MN"
2018,Mar,8926,8262,664,7.4,"Pennington County, MN"
2018,Apr,8798,8386,412,4.7,"Pennington County, MN"
2018,May,8795,8528,267,3.0,"Pennington County, MN"
2018,Jun,8831,8540,291,3.3,"Pennington County, MN"
2018,Jul,8633,8395,238,2.8,"Pennington County, MN"
2018,Aug,8578,8367,211,2.5,"Pennington County, MN"
2018,Sep,8697,8514,183,2.1,"Pennington County, MN"
2018,Oct,8740,8535,205,2.3,"Pennington County, MN"
2018,Nov,8758,8523,235,2.7,"Pennington County, MN"
2018,Dec,8864,8366,498,5.6,"Pennington County, MN"
2019,Jan,9035,8323,712,7.9,"Pennington County, MN"
2019,Feb,8926,8293,633,7.1,"Pennington County, MN"
2019,Mar,8929,8324,605,6.8,"Pennington County, MN"
2019,Apr,8826,8282,544,6.2,"Pennington County, MN"
2019,May,8757,8492,265,3.0,"Pennington County, MN"
2019,Jun,8788,8500,288,3.3,"Pennington County, MN"
2019,Jul,8583,8311,272,3.2,"Pennington County, MN"
2019,Aug,8471,8245,226,2.7,"Pennington County, MN"
2019,Sep,8597,8394,203,2.4,"Pennington County, MN"
2019,Oct,8672,8426,246,2.8,"Pennington County, MN"
2019,Nov,8621,8345,276,3.2,"Pennington County, MN"
2019,Dec,8829,8258,571,6.5,"Pennington County, MN"
2020,Jan,8983,8233,750,8.3,"Pennington County, MN"
2020,Feb,8810,8174,636,7.2,"Pennington County, MN"
2020,Mar,8834,8179,655,7.4,"Pennington County, MN"
2020,Apr,8297,7435,862,10.4,"Pennington County, MN"
2020,May,8382,7461,921,11.0,"Pennington County, MN"
2020,Jun,8888,8318,570,6.4,"Pennington County, MN"
2020,Jul,8775,8330,445,5.1,"Pennington County, MN"
2020,Aug,8669,8344,325,3.7,"Pennington County, MN"
2020,Sep,8722,8423,299,3.4,"Pennington County, MN"
2020,Oct,8746,8449,297,3.4,"Pennington County, MN"
2020,Nov,8772,8471,301,3.4,"Pennington County, MN"
2020,Dec,8764,8324,440,5.0,"Pennington County, MN"
2021,Jan,8747,8203,544,6.2,"Pennington County, MN"
2021,Feb,8782,8278,504,5.7,"Pennington County, MN"
2021,Mar,8785,8291,494,5.6,"Pennington County, MN"
2021,Apr,8736,8247,489,5.6,"Pennington County, MN"
2021,May,8672,8383,289,3.3,"Pennington County, MN"
2021,Jun,8694,8371,323,3.7,"Pennington County, MN"
2021,Jul,8671,8418,253,2.9,"Pennington County, MN"
2021,Aug,8569,8325,244,2.8,"Pennington County, MN"
2021,Sep,8732,8518,214,2.5,"Pennington County, MN"
2021,Oct,8678,8489,189,2.2,"Pennington County, MN"
2021,Nov,8711,8505,206,2.4,"Pennington County, MN"
2021,Dec,8891,8514,377,4.2,"Pennington County, MN"
2022,Jan,8853,8410,443,5.0,"Pennington County, MN"
2022,Feb,8814,8403,411,4.7,"Pennington County, MN"
2022,Mar,8920,8552,368,4.1,"Pennington County, MN"
2022,Apr,8718,8418,300,3.4,"Pennington County, MN"
2022,May,8764,8565,199,2.3,"Pennington County, MN"
2022,Jun,8851,8625,226,2.6,"Pennington County, MN"
2022,Jul,8773,8562,211,2.4,"Pennington County, MN"
2022,Aug,8770,8552,218,2.5,"Pennington County, MN"
2022,Sep,8693,8511,182,2.1,"Pennington County, MN"
2022,Oct,8702,8517,185,2.1,"Pennington County, MN"
2022,Nov,8668,8454,214,2.5,"Pennington County, MN"
2022,Dec,8813,8412,401,4.6,"Pennington County, MN"
2023,Jan,8800,8342,458,5.2,"Pennington County, MN"
2023,Feb,8801,8338,463,5.3,"Pennington County, MN"
2023,Mar,8868,8445,423,4.8,"Pennington County, MN"
2023,Apr,8747,8464,283,3.2,"Pennington County, MN"
2023,May,8693,8459,234,2.7,"Pennington County, MN"
2023,Jun,8736,8471,265,3.0,"Pennington County, MN"
2023,Jul,8625,8386,239,2.8,"Pennington County, MN"
2023,Aug,8605,8367,238,2.8,"Pennington County, MN"
2023,Sep,8609,8449,160,1.9,"Pennington County, MN"
2023,Oct,8577,8424,153,1.8,"Pennington County, MN"
2023,Nov,8600,8428,172,2.0,"Pennington County, MN"
2023,Dec,8593,8274,319,3.7,"Pennington County, MN"
2024,Jan,8721,8241,480,5.5,"Pennington County, MN"
2024,Feb,8700,8215,485,5.6,"Pennington County, MN"
2024,Mar,8801,8362,439,5.0,"Pennington County, MN"
2024,Apr,8624,8344,280,3.2,"Pennington County, MN"
2024,May,8560,8307,253,3.0,"Pennington County, MN"
2024,Jun,8678,8326,352,4.1,"Pennington County, MN"
2024,Jul,8736,8272,464,5.3,"Pennington County, MN"
2024,Aug,8674,8310,364,4.2,"Pennington County, MN"
2024,Sep,8627,8403,224,2.6,"Pennington County, MN"
2024,Oct,8548,8350,198,2.3,"Pennington County, MN"
2024,Nov,8584(P),8333(P),251(P),2.9(P),"Pennington County, MN"
P : Preliminary.,P : Preliminary.,P : Preliminary.,P : Preliminary.,P : Preliminary.,P : Preliminary.,"Pennington County, MN"
2014,Jan,14638,13353,1285,8.8,"Pine County, MN"
2014,Feb,14637,13359,1278,8.7,"Pine County, MN"
2014,Mar,14769,13469,1300,8.8,"Pine County, MN"
2014,Apr,14708,13606,1102,7.5,"Pine County, MN"
2014,May,14648,13831,817,5.6,"Pine County, MN"
2014,Jun,14581,13787,794,5.4,"Pine County, MN"
2014,Jul,14686,13911,775,5.3,"Pine County, MN"
2014,Aug,14475,13783,692,4.8,"Pine County, MN"
2014,Sep,14562,13926,636,4.4,"Pine County, MN"
2014,Oct,14670,14067,603,4.1,"Pine County, MN"
2014,Nov,14671,13872,799,5.4,"Pine County, MN"
2014,Dec,14699,13748,951,6.5,"Pine County, MN"
2015,Jan,14773,13575,1198,8.1,"Pine County, MN"
2015,Feb,14688,13515,1173,8.0,"Pine County, MN"
2015,Mar,14773,13603,1170,7.9,"Pine County, MN"
2015,Apr,14811,13960,851,5.7,"Pine County, MN"
2015,May,14827,14109,718,4.8,"Pine County, MN"
2015,Jun,14825,14075,750,5.1,"Pine County, MN"
2015,Jul,14840,14136,704,4.7,"Pine County, MN"
2015,Aug,14590,13960,630,4.3,"Pine County, MN"
2015,Sep,14673,14078,595,4.1,"Pine County, MN"
2015,Oct,15077,14482,595,3.9,"Pine County, MN"
2015,Nov,14930,14208,722,4.8,"Pine County, MN"
2015,Dec,15083,14091,992,6.6,"Pine County, MN"
2016,Jan,14956,13763,1193,8.0,"Pine County, MN"
2016,Feb,14849,13663,1186,8.0,"Pine County, MN"
2016,Mar,14968,13740,1228,8.2,"Pine County, MN"
2016,Apr,14770,13857,913,6.2,"Pine County, MN"
2016,May,14831,14164,667,4.5,"Pine County, MN"
2016,Jun,14691,13950,741,5.0,"Pine County, MN"
2016,Jul,14735,14055,680,4.6,"Pine County, MN"
2016,Aug,14639,13949,690,4.7,"Pine County, MN"
2016,Sep,14698,14052,646,4.4,"Pine County, MN"
2016,Oct,14871,14221,650,4.4,"Pine County, MN"
2016,Nov,14940,14188,752,5.0,"Pine County, MN"
2016,Dec,15009,13954,1055,7.0,"Pine County, MN"
2017,Jan,15379,14027,1352,8.8,"Pine County, MN"
2017,Feb,15275,14004,1271,8.3,"Pine County, MN"
2017,Mar,15346,14086,1260,8.2,"Pine County, MN"
2017,Apr,15084,14122,962,6.4,"Pine County, MN"
2017,May,14995,14303,692,4.6,"Pine County, MN"
2017,Jun,15124,14424,700,4.6,"Pine County, MN"
2017,Jul,15015,14365,650,4.3,"Pine County, MN"
2017,Aug,14884,14235,649,4.4,"Pine County, MN"
2017,Sep,14858,14310,548,3.7,"Pine County, MN"
2017,Oct,14795,14246,549,3.7,"Pine County, MN"
2017,Nov,14873,14109,764,5.1,"Pine County, MN"
2017,Dec,15057,14056,1001,6.6,"Pine County, MN"
2018,Jan,15003,13798,1205,8.0,"Pine County, MN"
2018,Feb,15046,13923,1123,7.5,"Pine County, MN"
2018,Mar,15004,13877,1127,7.5,"Pine County, MN"
2018,Apr,14947,14082,865,5.8,"Pine County, MN"
2018,May,14921,14331,590,4.0,"Pine County, MN"
2018,Jun,15041,14476,565,3.8,"Pine County, MN"
2018,Jul,14949,14446,503,3.4,"Pine County, MN"
2018,Aug,14665,14180,485,3.3,"Pine County, MN"
2018,Sep,14552,14155,397,2.7,"Pine County, MN"
2018,Oct,14729,14247,482,3.3,"Pine County, MN"
2018,Nov,14737,14133,604,4.1,"Pine County, MN"
2018,Dec,15097,14106,991,6.6,"Pine County, MN"
2019,Jan,15254,13860,1394,9.1,"Pine County, MN"
2019,Feb,15175,13956,1219,8.0,"Pine County, MN"
2019,Mar,15114,13927,1187,7.9,"Pine County, MN"
2019,Apr,15105,14179,926,6.1,"Pine County, MN"
2019,May,15040,14400,640,4.3,"Pine County, MN"
2019,Jun,15223,14563,660,4.3,"Pine County, MN"
2019,Jul,15259,14630,629,4.1,"Pine County, MN"
2019,Aug,15089,14504,585,3.9,"Pine County, MN"
2019,Sep,15018,14517,501,3.3,"Pine County, MN"
2019,Oct,15024,14467,557,3.7,"Pine County, MN"
2019,Nov,14963,14291,672,4.5,"Pine County, MN"
2019,Dec,15358,14219,1139,7.4,"Pine County, MN"
2020,Jan,15268,13900,1368,9.0,"Pine County, MN"
2020,Feb,15282,14014,1268,8.3,"Pine County, MN"
2020,Mar,15310,13861,1449,9.5,"Pine County, MN"
2020,Apr,13590,11800,1790,13.2,"Pine County, MN"
2020,May,13863,11750,2113,15.2,"Pine County, MN"
2020,Jun,14886,13414,1472,9.9,"Pine County, MN"
2020,Jul,14951,13664,1287,8.6,"Pine County, MN"
2020,Aug,14808,13801,1007,6.8,"Pine County, MN"
2020,Sep,14643,13725,918,6.3,"Pine County, MN"
2020,Oct,14672,13894,778,5.3,"Pine County, MN"
2020,Nov,14520,13693,827,5.7,"Pine County, MN"
2020,Dec,14213,13099,1114,7.8,"Pine County, MN"
2021,Jan,14278,12955,1323,9.3,"Pine County, MN"
2021,Feb,14319,13062,1257,8.8,"Pine County, MN"
2021,Mar,14177,13051,1126,7.9,"Pine County, MN"
2021,Apr,14242,13343,899,6.3,"Pine County, MN"
2021,May,14152,13519,633,4.5,"Pine County, MN"
2021,Jun,14268,13600,668,4.7,"Pine County, MN"
2021,Jul,14377,13793,584,4.1,"Pine County, MN"
2021,Aug,14282,13728,554,3.9,"Pine County, MN"
2021,Sep,14201,13716,485,3.4,"Pine County, MN"
2021,Oct,14233,13796,437,3.1,"Pine County, MN"
2021,Nov,14242,13783,459,3.2,"Pine County, MN"
2021,Dec,14490,13725,765,5.3,"Pine County, MN"
2022,Jan,14420,13425,995,6.9,"Pine County, MN"
2022,Feb,14514,13598,916,6.3,"Pine County, MN"
2022,Mar,14489,13657,832,5.7,"Pine County, MN"
2022,Apr,14377,13775,602,4.2,"Pine County, MN"
2022,May,14450,14007,443,3.1,"Pine County, MN"
2022,Jun,14524,14069,455,3.1,"Pine County, MN"
2022,Jul,14441,14017,424,2.9,"Pine County, MN"
2022,Aug,14375,13930,445,3.1,"Pine County, MN"
2022,Sep,14231,13874,357,2.5,"Pine County, MN"
2022,Oct,14239,13835,404,2.8,"Pine County, MN"
2022,Nov,14215,13683,532,3.7,"Pine County, MN"
2022,Dec,14514,13596,918,6.3,"Pine County, MN"
2023,Jan,14738,13633,1105,7.5,"Pine County, MN"
2023,Feb,14835,13666,1169,7.9,"Pine County, MN"
2023,Mar,14797,13690,1107,7.5,"Pine County, MN"
2023,Apr,14685,13801,884,6.0,"Pine County, MN"
2023,May,14635,14050,585,4.0,"Pine County, MN"
2023,Jun,14861,14220,641,4.3,"Pine County, MN"
2023,Jul,14692,14099,593,4.0,"Pine County, MN"
2023,Aug,14726,14153,573,3.9,"Pine County, MN"
2023,Sep,14431,14047,384,2.7,"Pine County, MN"
2023,Oct,14433,14049,384,2.7,"Pine County, MN"
2023,Nov,14400,13974,426,3.0,"Pine County, MN"
2023,Dec,14483,13745,738,5.1,"Pine County, MN"
2024,Jan,14617,13583,1034,7.1,"Pine County, MN"
2024,Feb,14682,13590,1092,7.4,"Pine County, MN"
2024,Mar,14737,13726,1011,6.9,"Pine County, MN"
2024,Apr,14646,13866,780,5.3,"Pine County, MN"
2024,May,14636,13869,767,5.2,"Pine County, MN"
2024,Jun,14678,13897,781,5.3,"Pine County, MN"
2024,Jul,14588,13869,719,4.9,"Pine County, MN"
2024,Aug,14675,13957,718,4.9,"Pine County, MN"
2024,Sep,14512,14009,503,3.5,"Pine County, MN"
2024,Oct,14480,14018,462,3.2,"Pine County, MN"
2024,Nov,14556(P),13920(P),636(P),4.4(P),"Pine County, MN"
P : Preliminary.,P : Preliminary.,P : Preliminary.,P : Preliminary.,P : Preliminary.,P : Preliminary.,"Pine County, MN"
2014,Jan,4648,4361,287,6.2,"Pipestone County, MN"
2014,Feb,4590,4309,281,6.1,"Pipestone County, MN"
2014,Mar,4686,4413,273,5.8,"Pipestone County, MN"
2014,Apr,4670,4481,189,4.0,"Pipestone County, MN"
2014,May,4740,4586,154,3.2,"Pipestone County, MN"
2014,Jun,4819,4650,169,3.5,"Pipestone County, MN"
2014,Jul,4885,4724,161,3.3,"Pipestone County, MN"
2014,Aug,4861,4718,143,2.9,"Pipestone County, MN"
2014,Sep,4846,4716,130,2.7,"Pipestone County, MN"
2014,Oct,4951,4835,116,2.3,"Pipestone County, MN"
2014,Nov,4931,4806,125,2.5,"Pipestone County, MN"
2014,Dec,4877,4689,188,3.9,"Pipestone County, MN"
2015,Jan,4989,4734,255,5.1,"Pipestone County, MN"
2015,Feb,4869,4610,259,5.3,"Pipestone County, MN"
2015,Mar,5006,4753,253,5.1,"Pipestone County, MN"
2015,Apr,4950,4805,145,2.9,"Pipestone County, MN"
2015,May,4947,4808,139,2.8,"Pipestone County, MN"
2015,Jun,5091,4940,151,3.0,"Pipestone County, MN"
2015,Jul,4957,4815,142,2.9,"Pipestone County, MN"
2015,Aug,4962,4836,126,2.5,"Pipestone County, MN"
2015,Sep,4899,4776,123,2.5,"Pipestone County, MN"
2015,Oct,5139,5015,124,2.4,"Pipestone County, MN"
2015,Nov,5053,4924,129,2.6,"Pipestone County, MN"
2015,Dec,4997,4799,198,4.0,"Pipestone County, MN"
2016,Jan,4974,4711,263,5.3,"Pipestone County, MN"
2016,Feb,4799,4530,269,5.6,"Pipestone County, MN"
2016,Mar,4881,4592,289,5.9,"Pipestone County, MN"
2016,Apr,4945,4746,199,4.0,"Pipestone County, MN"
2016,May,4916,4768,148,3.0,"Pipestone County, MN"
2016,Jun,5047,4874,173,3.4,"Pipestone County, MN"
2016,Jul,4917,4769,148,3.0,"Pipestone County, MN"
2016,Aug,4880,4738,142,2.9,"Pipestone County, MN"
2016,Sep,4739,4603,136,2.9,"Pipestone County, MN"
2016,Oct,4907,4769,138,2.8,"Pipestone County, MN"
2016,Nov,4913,4773,140,2.8,"Pipestone County, MN"
2016,Dec,4859,4666,193,4.0,"Pipestone County, MN"
2017,Jan,4910,4638,272,5.5,"Pipestone County, MN"
2017,Feb,4809,4531,278,5.8,"Pipestone County, MN"
2017,Mar,4857,4604,253,5.2,"Pipestone County, MN"
2017,Apr,4896,4722,174,3.6,"Pipestone County, MN"
2017,May,4885,4753,132,2.7,"Pipestone County, MN"
2017,Jun,5000,4845,155,3.1,"Pipestone County, MN"
2017,Jul,4959,4825,134,2.7,"Pipestone County, MN"
2017,Aug,4806,4683,123,2.6,"Pipestone County, MN"
2017,Sep,4811,4706,105,2.2,"Pipestone County, MN"
2017,Oct,4897,4811,86,1.8,"Pipestone County, MN"
2017,Nov,4870,4764,106,2.2,"Pipestone County, MN"
2017,Dec,4860,4706,154,3.2,"Pipestone County, MN"
2018,Jan,4824,4582,242,5.0,"Pipestone County, MN"
2018,Feb,4812,4566,246,5.1,"Pipestone County, MN"
2018,Mar,4885,4640,245,5.0,"Pipestone County, MN"
2018,Apr,4878,4699,179,3.7,"Pipestone County, MN"
2018,May,5054,4954,100,2.0,"Pipestone County, MN"
2018,Jun,5123,5002,121,2.4,"Pipestone County, MN"
2018,Jul,5100,5003,97,1.9,"Pipestone County, MN"
2018,Aug,4897,4807,90,1.8,"Pipestone County, MN"
2018,Sep,4930,4846,84,1.7,"Pipestone County, MN"
2018,Oct,4972,4885,87,1.7,"Pipestone County, MN"
2018,Nov,4866,4777,89,1.8,"Pipestone County, MN"
2018,Dec,4888,4714,174,3.6,"Pipestone County, MN"
2019,Jan,4819,4526,293,6.1,"Pipestone County, MN"
2019,Feb,4747,4485,262,5.5,"Pipestone County, MN"
2019,Mar,4784,4517,267,5.6,"Pipestone County, MN"
2019,Apr,4876,4676,200,4.1,"Pipestone County, MN"
2019,May,5026,4894,132,2.6,"Pipestone County, MN"
2019,Jun,5059,4910,149,2.9,"Pipestone County, MN"
2019,Jul,5158,5017,141,2.7,"Pipestone County, MN"
2019,Aug,4966,4839,127,2.6,"Pipestone County, MN"
2019,Sep,4990,4878,112,2.2,"Pipestone County, MN"
2019,Oct,5060,4952,108,2.1,"Pipestone County, MN"
2019,Nov,4995,4879,116,2.3,"Pipestone County, MN"
2019,Dec,4785,4599,186,3.9,"Pipestone County, MN"
2020,Jan,4541,4285,256,5.6,"Pipestone County, MN"
2020,Feb,4529,4282,247,5.5,"Pipestone County, MN"
2020,Mar,4457,4172,285,6.4,"Pipestone County, MN"
2020,Apr,4580,4367,213,4.7,"Pipestone County, MN"
2020,May,4648,4405,243,5.2,"Pipestone County, MN"
2020,Jun,4925,4718,207,4.2,"Pipestone County, MN"
2020,Jul,4965,4788,177,3.6,"Pipestone County, MN"
2020,Aug,4815,4674,141,2.9,"Pipestone County, MN"
2020,Sep,4721,4603,118,2.5,"Pipestone County, MN"
2020,Oct,4855,4735,120,2.5,"Pipestone County, MN"
2020,Nov,4762,4636,126,2.6,"Pipestone County, MN"
2020,Dec,4696,4512,184,3.9,"Pipestone County, MN"
2021,Jan,4481,4220,261,5.8,"Pipestone County, MN"
2021,Feb,4445,4210,235,5.3,"Pipestone County, MN"
2021,Mar,4407,4185,222,5.0,"Pipestone County, MN"
2021,Apr,4432,4292,140,3.2,"Pipestone County, MN"
2021,May,4553,4448,105,2.3,"Pipestone County, MN"
2021,Jun,4691,4543,148,3.2,"Pipestone County, MN"
2021,Jul,4737,4619,118,2.5,"Pipestone County, MN"
2021,Aug,4638,4517,121,2.6,"Pipestone County, MN"
2021,Sep,4561,4466,95,2.1,"Pipestone County, MN"
2021,Oct,4691,4615,76,1.6,"Pipestone County, MN"
2021,Nov,4689,4625,64,1.4,"Pipestone County, MN"
2021,Dec,4701,4602,99,2.1,"Pipestone County, MN"
2022,Jan,4550,4365,185,4.1,"Pipestone County, MN"
2022,Feb,4551,4376,175,3.8,"Pipestone County, MN"
2022,Mar,4526,4366,160,3.5,"Pipestone County, MN"
2022,Apr,4523,4415,108,2.4,"Pipestone County, MN"
2022,May,4613,4539,74,1.6,"Pipestone County, MN"
2022,Jun,4681,4585,96,2.1,"Pipestone County, MN"
2022,Jul,4850,4761,89,1.8,"Pipestone County, MN"
2022,Aug,4740,4647,93,2.0,"Pipestone County, MN"
2022,Sep,4652,4572,80,1.7,"Pipestone County, MN"
2022,Oct,4759,4685,74,1.6,"Pipestone County, MN"
2022,Nov,4697,4619,78,1.7,"Pipestone County, MN"
2022,Dec,4738,4609,129,2.7,"Pipestone County, MN"
2023,Jan,4563,4369,194,4.3,"Pipestone County, MN"
2023,Feb,4579,4357,222,4.8,"Pipestone County, MN"
2023,Mar,4520,4304,216,4.8,"Pipestone County, MN"
2023,Apr,4580,4426,154,3.4,"Pipestone County, MN"
2023,May,4650,4536,114,2.5,"Pipestone County, MN"
2023,Jun,4737,4598,139,2.9,"Pipestone County, MN"
2023,Jul,4736,4607,129,2.7,"Pipestone County, MN"
2023,Aug,4812,4698,114,2.4,"Pipestone County, MN"
2023,Sep,4745,4665,80,1.7,"Pipestone County, MN"
2023,Oct,4807,4733,74,1.5,"Pipestone County, MN"
2023,Nov,4819,4756,63,1.3,"Pipestone County, MN"
2023,Dec,4649,4563,86,1.8,"Pipestone County, MN"
2024,Jan,4533,4370,163,3.6,"Pipestone County, MN"
2024,Feb,4538,4332,206,4.5,"Pipestone County, MN"
2024,Mar,4599,4433,166,3.6,"Pipestone County, MN"
2024,Apr,4676,4562,114,2.4,"Pipestone County, MN"
2024,May,4655,4545,110,2.4,"Pipestone County, MN"
2024,Jun,4850,4696,154,3.2,"Pipestone County, MN"
2024,Jul,4923,4770,153,3.1,"Pipestone County, MN"
2024,Aug,5033,4893,140,2.8,"Pipestone County, MN"
2024,Sep,4952,4862,90,1.8,"Pipestone County, MN"
2024,Oct,4922,4832,90,1.8,"Pipestone County, MN"
2024,Nov,4952(P),4847(P),105(P),2.1(P),"Pipestone County, MN"
P : Preliminary.,P : Preliminary.,P : Preliminary.,P : Preliminary.,P : Preliminary.,P : Preliminary.,"Pipestone County, MN"
2014,Jan,17111,16024,1087,6.4,"Polk County, MN"
2014,Feb,17182,16114,1068,6.2,"Polk County, MN"
2014,Mar,17230,16165,1065,6.2,"Polk County, MN"
2014,Apr,16965,16119,846,5.0,"Polk County, MN"
2014,May,16823,16095,728,4.3,"Polk County, MN"
2014,Jun,17016,16161,855,5.0,"Polk County, MN"
2014,Jul,16947,16124,823,4.9,"Polk County, MN"
2014,Aug,16835,16082,753,4.5,"Polk County, MN"
2014,Sep,17120,16509,611,3.6,"Polk County, MN"
2014,Oct,17492,16961,531,3.0,"Polk County, MN"
2014,Nov,17430,16841,589,3.4,"Polk County, MN"
2014,Dec,17375,16639,736,4.2,"Polk County, MN"
2015,Jan,17387,16482,905,5.2,"Polk County, MN"
2015,Feb,17264,16388,876,5.1,"Polk County, MN"
2015,Mar,17498,16607,891,5.1,"Polk County, MN"
2015,Apr,17214,16476,738,4.3,"Polk County, MN"
2015,May,17156,16367,789,4.6,"Polk County, MN"
2015,Jun,17269,16426,843,4.9,"Polk County, MN"
2015,Jul,16814,16036,778,4.6,"Polk County, MN"
2015,Aug,16546,15881,665,4.0,"Polk County, MN"
2015,Sep,16946,16397,549,3.2,"Polk County, MN"
2015,Oct,17530,17020,510,2.9,"Polk County, MN"
2015,Nov,17441,16853,588,3.4,"Polk County, MN"
2015,Dec,17424,16657,767,4.4,"Polk County, MN"
2016,Jan,17553,16637,916,5.2,"Polk County, MN"
2016,Feb,17224,16385,839,4.9,"Polk County, MN"
2016,Mar,17501,16560,941,5.4,"Polk County, MN"
2016,Apr,17330,16550,780,4.5,"Polk County, MN"
2016,May,17049,16418,631,3.7,"Polk County, MN"
2016,Jun,17004,16176,828,4.9,"Polk County, MN"
2016,Jul,16689,15912,777,4.7,"Polk County, MN"
2016,Aug,16567,15842,725,4.4,"Polk County, MN"
2016,Sep,16934,16366,568,3.4,"Polk County, MN"
2016,Oct,17301,16746,555,3.2,"Polk County, MN"
2016,Nov,17268,16695,573,3.3,"Polk County, MN"
2016,Dec,17206,16416,790,4.6,"Polk County, MN"
2017,Jan,17424,16454,970,5.6,"Polk County, MN"
2017,Feb,17271,16354,917,5.3,"Polk County, MN"
2017,Mar,17320,16443,877,5.1,"Polk County, MN"
2017,Apr,17224,16493,731,4.2,"Polk County, MN"
2017,May,17032,16392,640,3.8,"Polk County, MN"
2017,Jun,17039,16235,804,4.7,"Polk County, MN"
2017,Jul,16714,15933,781,4.7,"Polk County, MN"
2017,Aug,16457,15705,752,4.6,"Polk County, MN"
2017,Sep,16866,16357,509,3.0,"Polk County, MN"
2017,Oct,17203,16760,443,2.6,"Polk County, MN"
2017,Nov,17188,16629,559,3.3,"Polk County, MN"
2017,Dec,17126,16419,707,4.1,"Polk County, MN"
2018,Jan,16920,16116,804,4.8,"Polk County, MN"
2018,Feb,17042,16239,803,4.7,"Polk County, MN"
2018,Mar,17027,16201,826,4.9,"Polk County, MN"
2018,Apr,16847,16178,669,4.0,"Polk County, MN"
2018,May,16903,16357,546,3.2,"Polk County, MN"
2018,Jun,16799,16060,739,4.4,"Polk County, MN"
2018,Jul,16602,15899,703,4.2,"Polk County, MN"
2018,Aug,15916,15353,563,3.5,"Polk County, MN"
2018,Sep,16474,16037,437,2.7,"Polk County, MN"
2018,Oct,16771,16360,411,2.5,"Polk County, MN"
2018,Nov,16585,16133,452,2.7,"Polk County, MN"
2018,Dec,16742,16081,661,3.9,"Polk County, MN"
2019,Jan,16735,15857,878,5.2,"Polk County, MN"
2019,Feb,16663,15850,813,4.9,"Polk County, MN"
2019,Mar,16755,15942,813,4.9,"Polk County, MN"
2019,Apr,16743,16064,679,4.1,"Polk County, MN"
2019,May,16971,16295,676,4.0,"Polk County, MN"
2019,Jun,16894,16098,796,4.7,"Polk County, MN"
2019,Jul,16737,15977,760,4.5,"Polk County, MN"
2019,Aug,16265,15660,605,3.7,"Polk County, MN"
2019,Sep,16750,16299,451,2.7,"Polk County, MN"
2019,Oct,17147,16702,445,2.6,"Polk County, MN"
2019,Nov,16855,16371,484,2.9,"Polk County, MN"
2019,Dec,16824,16161,663,3.9,"Polk County, MN"
2020,Jan,16193,15389,804,5.0,"Polk County, MN"
2020,Feb,16399,15603,796,4.9,"Polk County, MN"
2020,Mar,16365,15321,1044,6.4,"Polk County, MN"
2020,Apr,15618,14424,1194,7.6,"Polk County, MN"
2020,May,16080,14619,1461,9.1,"Polk County, MN"
2020,Jun,16447,15231,1216,7.4,"Polk County, MN"
2020,Jul,16727,15585,1142,6.8,"Polk County, MN"
2020,Aug,16465,15662,803,4.9,"Polk County, MN"
2020,Sep,16374,15677,697,4.3,"Polk County, MN"
2020,Oct,17093,16423,670,3.9,"Polk County, MN"
2020,Nov,16518,15805,713,4.3,"Polk County, MN"
2020,Dec,16290,15560,730,4.5,"Polk County, MN"
2021,Jan,16118,15258,860,5.3,"Polk County, MN"
2021,Feb,16220,15423,797,4.9,"Polk County, MN"
2021,Mar,16009,15192,817,5.1,"Polk County, MN"
2021,Apr,16012,15252,760,4.7,"Polk County, MN"
2021,May,15959,15262,697,4.4,"Polk County, MN"
2021,Jun,16034,15205,829,5.2,"Polk County, MN"
2021,Jul,16135,15341,794,4.9,"Polk County, MN"
2021,Aug,15809,15215,594,3.8,"Polk County, MN"
2021,Sep,15960,15502,458,2.9,"Polk County, MN"
2021,Oct,16183,15797,386,2.4,"Polk County, MN"
2021,Nov,16044,15648,396,2.5,"Polk County, MN"
2021,Dec,16160,15668,492,3.0,"Polk County, MN"
2022,Jan,16150,15511,639,4.0,"Polk County, MN"
2022,Feb,16197,15612,585,3.6,"Polk County, MN"
2022,Mar,16152,15596,556,3.4,"Polk County, MN"
2022,Apr,15848,15424,424,2.7,"Polk County, MN"
2022,May,15839,15469,370,2.3,"Polk County, MN"
2022,Jun,15752,15258,494,3.1,"Polk County, MN"
2022,Jul,16023,15561,462,2.9,"Polk County, MN"
2022,Aug,15810,15363,447,2.8,"Polk County, MN"
2022,Sep,15970,15655,315,2.0,"Polk County, MN"
2022,Oct,16247,15944,303,1.9,"Polk County, MN"
2022,Nov,16109,15754,355,2.2,"Polk County, MN"
2022,Dec,16239,15751,488,3.0,"Polk County, MN"
2023,Jan,16247,15684,563,3.5,"Polk County, MN"
2023,Feb,16309,15711,598,3.7,"Polk County, MN"
2023,Mar,16301,15745,556,3.4,"Polk County, MN"
2023,Apr,16049,15556,493,3.1,"Polk County, MN"
2023,May,16042,15601,441,2.7,"Polk County, MN"
2023,Jun,15989,15393,596,3.7,"Polk County, MN"
2023,Jul,16085,15505,580,3.6,"Polk County, MN"
2023,Aug,16293,15750,543,3.3,"Polk County, MN"
2023,Sep,16344,16016,328,2.0,"Polk County, MN"
2023,Oct,16553,16256,297,1.8,"Polk County, MN"
2023,Nov,16487,16187,300,1.8,"Polk County, MN"
2023,Dec,16345,15944,401,2.5,"Polk County, MN"
2024,Jan,16351,15809,542,3.3,"Polk County, MN"
2024,Feb,16432,15816,616,3.7,"Polk County, MN"
2024,Mar,16602,16054,548,3.3,"Polk County, MN"
2024,Apr,16519,16074,445,2.7,"Polk County, MN"
2024,May,16186,15747,439,2.7,"Polk County, MN"
2024,Jun,16361,15628,733,4.5,"Polk County, MN"
2024,Jul,16701,15919,782,4.7,"Polk County, MN"
2024,Aug,16881,16203,678,4.0,"Polk County, MN"
2024,Sep,16853,16430,423,2.5,"Polk County, MN"
2024,Oct,16872,16521,351,2.1,"Polk County, MN"
2024,Nov,17038(P),16582(P),456(P),2.7(P),"Polk County, MN"
P : Preliminary.,P : Preliminary.,P : Preliminary.,P : Preliminary.,P : Preliminary.,P : Preliminary.,"Polk County, MN"
2014,Jan,5966,5632,334,5.6,"Pope County, MN"
2014,Feb,5910,5591,319,5.4,"Pope County, MN"
2014,Mar,5995,5677,318,5.3,"Pope County, MN"
2014,Apr,6012,5778,234,3.9,"Pope County, MN"
2014,May,6054,5864,190,3.1,"Pope County, MN"
2014,Jun,6195,5986,209,3.4,"Pope County, MN"
2014,Jul,6545,6341,204,3.1,"Pope County, MN"
2014,Aug,6449,6257,192,3.0,"Pope County, MN"
2014,Sep,6377,6204,173,2.7,"Pope County, MN"
2014,Oct,6485,6323,162,2.5,"Pope County, MN"
2014,Nov,6416,6212,204,3.2,"Pope County, MN"
2014,Dec,6438,6187,251,3.9,"Pope County, MN"
2015,Jan,6472,6155,317,4.9,"Pope County, MN"
2015,Feb,6416,6112,304,4.7,"Pope County, MN"
2015,Mar,6498,6198,300,4.6,"Pope County, MN"
2015,Apr,6310,6097,213,3.4,"Pope County, MN"
2015,May,6406,6192,214,3.3,"Pope County, MN"
2015,Jun,6570,6339,231,3.5,"Pope County, MN"
2015,Jul,6478,6266,212,3.3,"Pope County, MN"
2015,Aug,6312,6136,176,2.8,"Pope County, MN"
2015,Sep,6187,6030,157,2.5,"Pope County, MN"
2015,Oct,6434,6261,173,2.7,"Pope County, MN"
2015,Nov,6382,6204,178,2.8,"Pope County, MN"
2015,Dec,6372,6119,253,4.0,"Pope County, MN"
2016,Jan,6347,6012,335,5.3,"Pope County, MN"
2016,Feb,6185,5876,309,5.0,"Pope County, MN"
2016,Mar,6307,6006,301,4.8,"Pope County, MN"
2016,Apr,6261,6073,188,3.0,"Pope County, MN"
2016,May,6277,6105,172,2.7,"Pope County, MN"
2016,Jun,6373,6171,202,3.2,"Pope County, MN"
2016,Jul,6339,6150,189,3.0,"Pope County, MN"
2016,Aug,6244,6067,177,2.8,"Pope County, MN"
2016,Sep,6127,5961,166,2.7,"Pope County, MN"
2016,Oct,6380,6214,166,2.6,"Pope County, MN"
2016,Nov,6382,6188,194,3.0,"Pope County, MN"
2016,Dec,6364,6079,285,4.5,"Pope County, MN"
2017,Jan,6399,6071,328,5.1,"Pope County, MN"
2017,Feb,6335,6038,297,4.7,"Pope County, MN"
2017,Mar,6337,6065,272,4.3,"Pope County, MN"
2017,Apr,6452,6263,189,2.9,"Pope County, MN"
2017,May,6460,6308,152,2.4,"Pope County, MN"
2017,Jun,6529,6356,173,2.6,"Pope County, MN"
2017,Jul,6394,6230,164,2.6,"Pope County, MN"
2017,Aug,6280,6132,148,2.4,"Pope County, MN"
2017,Sep,6238,6105,133,2.1,"Pope County, MN"
2017,Oct,6452,6328,124,1.9,"Pope County, MN"
2017,Nov,6396,6229,167,2.6,"Pope County, MN"
2017,Dec,6381,6156,225,3.5,"Pope County, MN"
2018,Jan,6266,6009,257,4.1,"Pope County, MN"
2018,Feb,6318,6078,240,3.8,"Pope County, MN"
2018,Mar,6329,6100,229,3.6,"Pope County, MN"
2018,Apr,6412,6228,184,2.9,"Pope County, MN"
2018,May,6518,6391,127,1.9,"Pope County, MN"
2018,Jun,6590,6440,150,2.3,"Pope County, MN"
2018,Jul,6525,6395,130,2.0,"Pope County, MN"
2018,Aug,6354,6227,127,2.0,"Pope County, MN"
2018,Sep,6333,6220,113,1.8,"Pope County, MN"
2018,Oct,6484,6364,120,1.9,"Pope County, MN"
2018,Nov,6380,6235,145,2.3,"Pope County, MN"
2018,Dec,6500,6253,247,3.8,"Pope County, MN"
2019,Jan,6441,6148,293,4.5,"Pope County, MN"
2019,Feb,6421,6154,267,4.2,"Pope County, MN"
2019,Mar,6411,6144,267,4.2,"Pope County, MN"
2019,Apr,6535,6334,201,3.1,"Pope County, MN"
2019,May,6663,6496,167,2.5,"Pope County, MN"
2019,Jun,6714,6516,198,2.9,"Pope County, MN"
2019,Jul,6757,6555,202,3.0,"Pope County, MN"
2019,Aug,6598,6428,170,2.6,"Pope County, MN"
2019,Sep,6578,6422,156,2.4,"Pope County, MN"
2019,Oct,6619,6478,141,2.1,"Pope County, MN"
2019,Nov,6459,6278,181,2.8,"Pope County, MN"
2019,Dec,6512,6268,244,3.7,"Pope County, MN"
2020,Jan,6335,6060,275,4.3,"Pope County, MN"
2020,Feb,6370,6113,257,4.0,"Pope County, MN"
2020,Mar,6319,6013,306,4.8,"Pope County, MN"
2020,Apr,6272,5893,379,6.0,"Pope County, MN"
2020,May,6490,6083,407,6.3,"Pope County, MN"
2020,Jun,6777,6436,341,5.0,"Pope County, MN"
2020,Jul,6996,6655,341,4.9,"Pope County, MN"
2020,Aug,6836,6563,273,4.0,"Pope County, MN"
2020,Sep,6638,6387,251,3.8,"Pope County, MN"
2020,Oct,6818,6609,209,3.1,"Pope County, MN"
2020,Nov,6580,6350,230,3.5,"Pope County, MN"
2020,Dec,6519,6228,291,4.5,"Pope County, MN"
2021,Jan,6422,6069,353,5.5,"Pope County, MN"
2021,Feb,6402,6084,318,5.0,"Pope County, MN"
2021,Mar,6300,6005,295,4.7,"Pope County, MN"
2021,Apr,6411,6188,223,3.5,"Pope County, MN"
2021,May,6511,6338,173,2.7,"Pope County, MN"
2021,Jun,6601,6395,206,3.1,"Pope County, MN"
2021,Jul,6665,6501,164,2.5,"Pope County, MN"
2021,Aug,6584,6433,151,2.3,"Pope County, MN"
2021,Sep,6337,6216,121,1.9,"Pope County, MN"
2021,Oct,6580,6473,107,1.6,"Pope County, MN"
2021,Nov,6507,6389,118,1.8,"Pope County, MN"
2021,Dec,6603,6419,184,2.8,"Pope County, MN"
2022,Jan,6473,6239,234,3.6,"Pope County, MN"
2022,Feb,6451,6237,214,3.3,"Pope County, MN"
2022,Mar,6449,6254,195,3.0,"Pope County, MN"
2022,Apr,6407,6270,137,2.1,"Pope County, MN"
2022,May,6485,6378,107,1.6,"Pope County, MN"
2022,Jun,6588,6456,132,2.0,"Pope County, MN"
2022,Jul,6644,6526,118,1.8,"Pope County, MN"
2022,Aug,6554,6440,114,1.7,"Pope County, MN"
2022,Sep,6389,6289,100,1.6,"Pope County, MN"
2022,Oct,6504,6409,95,1.5,"Pope County, MN"
2022,Nov,6386,6246,140,2.2,"Pope County, MN"
2022,Dec,6528,6307,221,3.4,"Pope County, MN"
2023,Jan,6422,6170,252,3.9,"Pope County, MN"
2023,Feb,6460,6207,253,3.9,"Pope County, MN"
2023,Mar,6421,6193,228,3.6,"Pope County, MN"
2023,Apr,6486,6289,197,3.0,"Pope County, MN"
2023,May,6556,6409,147,2.2,"Pope County, MN"
2023,Jun,6688,6501,187,2.8,"Pope County, MN"
2023,Jul,6610,6443,167,2.5,"Pope County, MN"
2023,Aug,6684,6507,177,2.6,"Pope County, MN"
2023,Sep,6335,6217,118,1.9,"Pope County, MN"
2023,Oct,6475,6365,110,1.7,"Pope County, MN"
2023,Nov,6416,6282,134,2.1,"Pope County, MN"
2023,Dec,6335,6137,198,3.1,"Pope County, MN"
2024,Jan,6287,6043,244,3.9,"Pope County, MN"
2024,Feb,6302,6037,265,4.2,"Pope County, MN"
2024,Mar,6367,6131,236,3.7,"Pope County, MN"
2024,Apr,6434,6255,179,2.8,"Pope County, MN"
2024,May,6418,6227,191,3.0,"Pope County, MN"
2024,Jun,6586,6358,228,3.5,"Pope County, MN"
2024,Jul,6647,6403,244,3.7,"Pope County, MN"
2024,Aug,6745,6515,230,3.4,"Pope County, MN"
2024,Sep,6557,6413,144,2.2,"Pope County, MN"
2024,Oct,6576,6429,147,2.2,"Pope County, MN"
2024,Nov,6548(P),6351(P),197(P),3.0(P),"Pope County, MN"
P : Preliminary.,P : Preliminary.,P : Preliminary.,P : Preliminary.,P : Preliminary.,P : Preliminary.,"Pope County, MN"
2014,Jan,274598,261118,13480,4.9,"Ramsey County, MN"
2014,Feb,275153,261629,13524,4.9,"Ramsey County, MN"
2014,Mar,276043,262692,13351,4.8,"Ramsey County, MN"
2014,Apr,276726,265598,11128,4.0,"Ramsey County, MN"
2014,May,278675,267672,11003,3.9,"Ramsey County, MN"
2014,Jun,281056,268603,12453,4.4,"Ramsey County, MN"
2014,Jul,281965,269772,12193,4.3,"Ramsey County, MN"
2014,Aug,279396,267929,11467,4.1,"Ramsey County, MN"
2014,Sep,278269,267735,10534,3.8,"Ramsey County, MN"
2014,Oct,278540,268986,9554,3.4,"Ramsey County, MN"
2014,Nov,278475,269178,9297,3.3,"Ramsey County, MN"
2014,Dec,277142,267377,9765,3.5,"Ramsey County, MN"
2015,Jan,276292,264910,11382,4.1,"Ramsey County, MN"
2015,Feb,277721,266689,11032,4.0,"Ramsey County, MN"
2015,Mar,277016,266095,10921,3.9,"Ramsey County, MN"
2015,Apr,279724,270298,9426,3.4,"Ramsey County, MN"
2015,May,282918,272998,9920,3.5,"Ramsey County, MN"
2015,Jun,282776,271636,11140,3.9,"Ramsey County, MN"
2015,Jul,284853,273948,10905,3.8,"Ramsey County, MN"
2015,Aug,282498,272332,10166,3.6,"Ramsey County, MN"
2015,Sep,279890,270521,9369,3.3,"Ramsey County, MN"
2015,Oct,279299,270275,9024,3.2,"Ramsey County, MN"
2015,Nov,279984,271439,8545,3.1,"Ramsey County, MN"
2015,Dec,279935,270553,9382,3.4,"Ramsey County, MN"
2016,Jan,277762,267098,10664,3.8,"Ramsey County, MN"
2016,Feb,280639,269925,10714,3.8,"Ramsey County, MN"
2016,Mar,280050,269161,10889,3.9,"Ramsey County, MN"
2016,Apr,281553,272149,9404,3.3,"Ramsey County, MN"
2016,May,282415,273297,9118,3.2,"Ramsey County, MN"
2016,Jun,283528,272243,11285,4.0,"Ramsey County, MN"
2016,Jul,286735,276014,10721,3.7,"Ramsey County, MN"
2016,Aug,285211,274547,10664,3.7,"Ramsey County, MN"
2016,Sep,284272,274218,10054,3.5,"Ramsey County, MN"
2016,Oct,282106,272447,9659,3.4,"Ramsey County, MN"
2016,Nov,281306,272417,8889,3.2,"Ramsey County, MN"
2016,Dec,281152,271183,9969,3.5,"Ramsey County, MN"
2017,Jan,282536,271571,10965,3.9,"Ramsey County, MN"
2017,Feb,285017,274136,10881,3.8,"Ramsey County, MN"
2017,Mar,285878,275686,10192,3.6,"Ramsey County, MN"
2017,Apr,286886,277772,9114,3.2,"Ramsey County, MN"
2017,May,287732,278523,9209,3.2,"Ramsey County, MN"
2017,Jun,291124,280348,10776,3.7,"Ramsey County, MN"
2017,Jul,293272,283181,10091,3.4,"Ramsey County, MN"
2017,Aug,291436,281430,10006,3.4,"Ramsey County, MN"
2017,Sep,291310,282712,8598,3.0,"Ramsey County, MN"
2017,Oct,287403,279914,7489,2.6,"Ramsey County, MN"
2017,Nov,288173,280656,7517,2.6,"Ramsey County, MN"
2017,Dec,287294,279044,8250,2.9,"Ramsey County, MN"
2018,Jan,285902,277119,8783,3.1,"Ramsey County, MN"
2018,Feb,288402,279437,8965,3.1,"Ramsey County, MN"
2018,Mar,286890,278036,8854,3.1,"Ramsey County, MN"
2018,Apr,286036,278684,7352,2.6,"Ramsey County, MN"
2018,May,287388,280335,7053,2.5,"Ramsey County, MN"
2018,Jun,290498,281303,9195,3.2,"Ramsey County, MN"
2018,Jul,291784,283443,8341,2.9,"Ramsey County, MN"
2018,Aug,289753,281545,8208,2.8,"Ramsey County, MN"
2018,Sep,288508,281201,7307,2.5,"Ramsey County, MN"
2018,Oct,288311,281364,6947,2.4,"Ramsey County, MN"
2018,Nov,288951,282274,6677,2.3,"Ramsey County, MN"
2018,Dec,289264,280919,8345,2.9,"Ramsey County, MN"
2019,Jan,287360,277904,9456,3.3,"Ramsey County, MN"
2019,Feb,288477,279492,8985,3.1,"Ramsey County, MN"
2019,Mar,287985,278567,9418,3.3,"Ramsey County, MN"
2019,Apr,287303,279513,7790,2.7,"Ramsey County, MN"
2019,May,288692,280285,8407,2.9,"Ramsey County, MN"
2019,Jun,292441,282195,10246,3.5,"Ramsey County, MN"
2019,Jul,293773,284017,9756,3.3,"Ramsey County, MN"
2019,Aug,293200,283788,9412,3.2,"Ramsey County, MN"
2019,Sep,291870,283689,8181,2.8,"Ramsey County, MN"
2019,Oct,291388,283128,8260,2.8,"Ramsey County, MN"
2019,Nov,291618,283867,7751,2.7,"Ramsey County, MN"
2019,Dec,291709,283424,8285,2.8,"Ramsey County, MN"
2020,Jan,289736,280896,8840,3.1,"Ramsey County, MN"
2020,Feb,291080,282222,8858,3.0,"Ramsey County, MN"
2020,Mar,290340,278020,12320,4.2,"Ramsey County, MN"
2020,Apr,277278,251248,26030,9.4,"Ramsey County, MN"
2020,May,284487,248072,36415,12.8,"Ramsey County, MN"
2020,Jun,297181,264654,32527,10.9,"Ramsey County, MN"
2020,Jul,299619,269728,29891,10.0,"Ramsey County, MN"
2020,Aug,298352,274529,23823,8.0,"Ramsey County, MN"
2020,Sep,294772,273131,21641,7.3,"Ramsey County, MN"
2020,Oct,291460,274513,16947,5.8,"Ramsey County, MN"
2020,Nov,288224,274881,13343,4.6,"Ramsey County, MN"
2020,Dec,282712,268348,14364,5.1,"Ramsey County, MN"
2021,Jan,279880,265222,14658,5.2,"Ramsey County, MN"
2021,Feb,280053,266619,13434,4.8,"Ramsey County, MN"
2021,Mar,280531,267157,13374,4.8,"Ramsey County, MN"
2021,Apr,282037,269133,12904,4.6,"Ramsey County, MN"
2021,May,282607,270123,12484,4.4,"Ramsey County, MN"
2021,Jun,283998,269506,14492,5.1,"Ramsey County, MN"
2021,Jul,285067,272583,12484,4.4,"Ramsey County, MN"
2021,Aug,283164,271213,11951,4.2,"Ramsey County, MN"
2021,Sep,281503,270821,10682,3.8,"Ramsey County, MN"
2021,Oct,281803,272560,9243,3.3,"Ramsey County, MN"
2021,Nov,282518,275063,7455,2.6,"Ramsey County, MN"
2021,Dec,281824,273964,7860,2.8,"Ramsey County, MN"
2022,Jan,281670,272799,8871,3.1,"Ramsey County, MN"
2022,Feb,282019,274230,7789,2.8,"Ramsey County, MN"
2022,Mar,282610,274927,7683,2.7,"Ramsey County, MN"
2022,Apr,283913,278055,5858,2.1,"Ramsey County, MN"
2022,May,285805,279382,6423,2.2,"Ramsey County, MN"
2022,Jun,286463,278089,8374,2.9,"Ramsey County, MN"
2022,Jul,287469,279634,7835,2.7,"Ramsey County, MN"
2022,Aug,287405,279121,8284,2.9,"Ramsey County, MN"
2022,Sep,285574,278792,6782,2.4,"Ramsey County, MN"
2022,Oct,283276,276651,6625,2.3,"Ramsey County, MN"
2022,Nov,282766,276510,6256,2.2,"Ramsey County, MN"
2022,Dec,283101,275833,7268,2.6,"Ramsey County, MN"
2023,Jan,283103,275300,7803,2.8,"Ramsey County, MN"
2023,Feb,284171,275935,8236,2.9,"Ramsey County, MN"
2023,Mar,285438,277340,8098,2.8,"Ramsey County, MN"
2023,Apr,286486,279307,7179,2.5,"Ramsey County, MN"
2023,May,288421,280469,7952,2.8,"Ramsey County, MN"
2023,Jun,291202,281783,9419,3.2,"Ramsey County, MN"
2023,Jul,291243,282404,8839,3.0,"Ramsey County, MN"
2023,Aug,288878,279535,9343,3.2,"Ramsey County, MN"
2023,Sep,287016,279815,7201,2.5,"Ramsey County, MN"
2023,Oct,285488,278798,6690,2.3,"Ramsey County, MN"
2023,Nov,284705,279464,5241,1.8,"Ramsey County, MN"
2023,Dec,283231,276773,6458,2.3,"Ramsey County, MN"
2024,Jan,284062,276105,7957,2.8,"Ramsey County, MN"
2024,Feb,286114,276932,9182,3.2,"Ramsey County, MN"
2024,Mar,285877,277916,7961,2.8,"Ramsey County, MN"
2024,Apr,286441,279081,7360,2.6,"Ramsey County, MN"
2024,May,285388,278076,7312,2.6,"Ramsey County, MN"
2024,Jun,285202,274361,10841,3.8,"Ramsey County, MN"
2024,Jul,286170,274933,11237,3.9,"Ramsey County, MN"
2024,Aug,284809,273013,11796,4.1,"Ramsey County, MN"
2024,Sep,283630,274450,9180,3.2,"Ramsey County, MN"
2024,Oct,283939,275770,8169,2.9,"Ramsey County, MN"
2024,Nov,283395(P),274729(P),8666(P),3.1(P),"Ramsey County, MN"
P : Preliminary.,P : Preliminary.,P : Preliminary.,P : Preliminary.,P : Preliminary.,P : Preliminary.,"Ramsey County, MN"
2014,Jan,2245,2014,231,10.3,"Red Lake County, MN"
2014,Feb,2235,2026,209,9.4,"Red Lake County, MN"
2014,Mar,2266,2056,210,9.3,"Red Lake County, MN"
2014,Apr,2242,2081,161,7.2,"Red Lake County, MN"
2014,May,2236,2131,105,4.7,"Red Lake County, MN"
2014,Jun,2281,2171,110,4.8,"Red Lake County, MN"
2014,Jul,2266,2148,118,5.2,"Red Lake County, MN"
2014,Aug,2265,2173,92,4.1,"Red Lake County, MN"
2014,Sep,2238,2161,77,3.4,"Red Lake County, MN"
2014,Oct,2294,2221,73,3.2,"Red Lake County, MN"
2014,Nov,2301,2214,87,3.8,"Red Lake County, MN"
2014,Dec,2310,2174,136,5.9,"Red Lake County, MN"
2015,Jan,2357,2145,212,9.0,"Red Lake County, MN"
2015,Feb,2307,2122,185,8.0,"Red Lake County, MN"
2015,Mar,2368,2170,198,8.4,"Red Lake County, MN"
2015,Apr,2346,2211,135,5.8,"Red Lake County, MN"
2015,May,2338,2233,105,4.5,"Red Lake County, MN"
2015,Jun,2389,2258,131,5.5,"Red Lake County, MN"
2015,Jul,2280,2176,104,4.6,"Red Lake County, MN"
2015,Aug,2256,2164,92,4.1,"Red Lake County, MN"
2015,Sep,2258,2171,87,3.9,"Red Lake County, MN"
2015,Oct,2360,2272,88,3.7,"Red Lake County, MN"
2015,Nov,2374,2235,139,5.9,"Red Lake County, MN"
2015,Dec,2396,2190,206,8.6,"Red Lake County, MN"
2016,Jan,2375,2121,254,10.7,"Red Lake County, MN"
2016,Feb,2301,2086,215,9.3,"Red Lake County, MN"
2016,Mar,2353,2097,256,10.9,"Red Lake County, MN"
2016,Apr,2296,2113,183,8.0,"Red Lake County, MN"
2016,May,2273,2155,118,5.2,"Red Lake County, MN"
2016,Jun,2280,2152,128,5.6,"Red Lake County, MN"
2016,Jul,2220,2098,122,5.5,"Red Lake County, MN"
2016,Aug,2240,2097,143,6.4,"Red Lake County, MN"
2016,Sep,2200,2097,103,4.7,"Red Lake County, MN"
2016,Oct,2300,2173,127,5.5,"Red Lake County, MN"
2016,Nov,2312,2158,154,6.7,"Red Lake County, MN"
2016,Dec,2308,2101,207,9.0,"Red Lake County, MN"
2017,Jan,2367,2094,273,11.5,"Red Lake County, MN"
2017,Feb,2336,2083,253,10.8,"Red Lake County, MN"
2017,Mar,2360,2104,256,10.8,"Red Lake County, MN"
2017,Apr,2314,2105,209,9.0,"Red Lake County, MN"
2017,May,2262,2157,105,4.6,"Red Lake County, MN"
2017,Jun,2252,2149,103,4.6,"Red Lake County, MN"
2017,Jul,2182,2084,98,4.5,"Red Lake County, MN"
2017,Aug,2170,2061,109,5.0,"Red Lake County, MN"
2017,Sep,2184,2111,73,3.3,"Red Lake County, MN"
2017,Oct,2230,2158,72,3.2,"Red Lake County, MN"
2017,Nov,2231,2134,97,4.3,"Red Lake County, MN"
2017,Dec,2254,2091,163,7.2,"Red Lake County, MN"
2018,Jan,2258,2075,183,8.1,"Red Lake County, MN"
2018,Feb,2265,2098,167,7.4,"Red Lake County, MN"
2018,Mar,2299,2097,202,8.8,"Red Lake County, MN"
2018,Apr,2238,2109,129,5.8,"Red Lake County, MN"
2018,May,2242,2133,109,4.9,"Red Lake County, MN"
2018,Jun,2242,2129,113,5.0,"Red Lake County, MN"
2018,Jul,2201,2106,95,4.3,"Red Lake County, MN"
2018,Aug,2149,2073,76,3.5,"Red Lake County, MN"
2018,Sep,2175,2112,63,2.9,"Red Lake County, MN"
2018,Oct,2214,2150,64,2.9,"Red Lake County, MN"
2018,Nov,2239,2147,92,4.1,"Red Lake County, MN"
2018,Dec,2238,2118,120,5.4,"Red Lake County, MN"
2019,Jan,2254,2066,188,8.3,"Red Lake County, MN"
2019,Feb,2228,2066,162,7.3,"Red Lake County, MN"
2019,Mar,2243,2069,174,7.8,"Red Lake County, MN"
2019,Apr,2248,2115,133,5.9,"Red Lake County, MN"
2019,May,2253,2159,94,4.2,"Red Lake County, MN"
2019,Jun,2267,2164,103,4.5,"Red Lake County, MN"
2019,Jul,2237,2140,97,4.3,"Red Lake County, MN"
2019,Aug,2191,2103,88,4.0,"Red Lake County, MN"
2019,Sep,2208,2133,75,3.4,"Red Lake County, MN"
2019,Oct,2239,2153,86,3.8,"Red Lake County, MN"
2019,Nov,2216,2133,83,3.7,"Red Lake County, MN"
2019,Dec,2255,2114,141,6.3,"Red Lake County, MN"
2020,Jan,2275,2067,208,9.1,"Red Lake County, MN"
2020,Feb,2243,2050,193,8.6,"Red Lake County, MN"
2020,Mar,2223,2034,189,8.5,"Red Lake County, MN"
2020,Apr,2157,1950,207,9.6,"Red Lake County, MN"
2020,May,2211,1986,225,10.2,"Red Lake County, MN"
2020,Jun,2249,2104,145,6.4,"Red Lake County, MN"
2020,Jul,2256,2132,124,5.5,"Red Lake County, MN"
2020,Aug,2222,2139,83,3.7,"Red Lake County, MN"
2020,Sep,2246,2169,77,3.4,"Red Lake County, MN"
2020,Oct,2308,2223,85,3.7,"Red Lake County, MN"
2020,Nov,2251,2158,93,4.1,"Red Lake County, MN"
2020,Dec,2250,2132,118,5.2,"Red Lake County, MN"
2021,Jan,2216,2071,145,6.5,"Red Lake County, MN"
2021,Feb,2216,2089,127,5.7,"Red Lake County, MN"
2021,Mar,2188,2059,129,5.9,"Red Lake County, MN"
2021,Apr,2195,2086,109,5.0,"Red Lake County, MN"
2021,May,2161,2087,74,3.4,"Red Lake County, MN"
2021,Jun,2228,2130,98,4.4,"Red Lake County, MN"
2021,Jul,2181,2107,74,3.4,"Red Lake County, MN"
2021,Aug,2177,2096,81,3.7,"Red Lake County, MN"
2021,Sep,2190,2131,59,2.7,"Red Lake County, MN"
2021,Oct,2176,2118,58,2.7,"Red Lake County, MN"
2021,Nov,2168,2101,67,3.1,"Red Lake County, MN"
2021,Dec,2214,2127,87,3.9,"Red Lake County, MN"
2022,Jan,2221,2095,126,5.7,"Red Lake County, MN"
2022,Feb,2205,2097,108,4.9,"Red Lake County, MN"
2022,Mar,2202,2103,99,4.5,"Red Lake County, MN"
2022,Apr,2167,2083,84,3.9,"Red Lake County, MN"
2022,May,2184,2116,68,3.1,"Red Lake County, MN"
2022,Jun,2177,2112,65,3.0,"Red Lake County, MN"
2022,Jul,2155,2095,60,2.8,"Red Lake County, MN"
2022,Aug,2152,2077,75,3.5,"Red Lake County, MN"
2022,Sep,2150,2097,53,2.5,"Red Lake County, MN"
2022,Oct,2187,2128,59,2.7,"Red Lake County, MN"
2022,Nov,2166,2093,73,3.4,"Red Lake County, MN"
2022,Dec,2177,2093,84,3.9,"Red Lake County, MN"
2023,Jan,2181,2057,124,5.7,"Red Lake County, MN"
2023,Feb,2190,2061,129,5.9,"Red Lake County, MN"
2023,Mar,2202,2085,117,5.3,"Red Lake County, MN"
2023,Apr,2187,2082,105,4.8,"Red Lake County, MN"
2023,May,2187,2114,73,3.3,"Red Lake County, MN"
2023,Jun,2163,2080,83,3.8,"Red Lake County, MN"
2023,Jul,2114,2039,75,3.5,"Red Lake County, MN"
2023,Aug,2146,2066,80,3.7,"Red Lake County, MN"
2023,Sep,2126,2080,46,2.2,"Red Lake County, MN"
2023,Oct,2151,2111,40,1.9,"Red Lake County, MN"
2023,Nov,2170,2110,60,2.8,"Red Lake County, MN"
2023,Dec,2142,2065,77,3.6,"Red Lake County, MN"
2024,Jan,2151,2036,115,5.3,"Red Lake County, MN"
2024,Feb,2151,2029,122,5.7,"Red Lake County, MN"
2024,Mar,2186,2072,114,5.2,"Red Lake County, MN"
2024,Apr,2169,2089,80,3.7,"Red Lake County, MN"
2024,May,2148,2065,83,3.9,"Red Lake County, MN"
2024,Jun,2189,2070,119,5.4,"Red Lake County, MN"
2024,Jul,2192,2055,137,6.3,"Red Lake County, MN"
2024,Aug,2215,2105,110,5.0,"Red Lake County, MN"
2024,Sep,2189,2126,63,2.9,"Red Lake County, MN"
2024,Oct,2191,2126,65,3.0,"Red Lake County, MN"
2024,Nov,2212(P),2124(P),88(P),4.0(P),"Red Lake County, MN"
P : Preliminary.,P : Preliminary.,P : Preliminary.,P : Preliminary.,P : Preliminary.,P : Preliminary.,"Red Lake County, MN"
2014,Jan,7869,7354,515,6.5,"Redwood County, MN"
2014,Feb,7856,7361,495,6.3,"Redwood County, MN"
2014,Mar,7937,7465,472,5.9,"Redwood County, MN"
2014,Apr,7803,7442,361,4.6,"Redwood County, MN"
2014,May,7972,7645,327,4.1,"Redwood County, MN"
2014,Jun,8170,7801,369,4.5,"Redwood County, MN"
2014,Jul,8201,7860,341,4.2,"Redwood County, MN"
2014,Aug,8091,7786,305,3.8,"Redwood County, MN"
2014,Sep,7930,7664,266,3.4,"Redwood County, MN"
2014,Oct,8122,7865,257,3.2,"Redwood County, MN"
2014,Nov,8050,7784,266,3.3,"Redwood County, MN"
2014,Dec,8243,7873,370,4.5,"Redwood County, MN"
2015,Jan,8275,7814,461,5.6,"Redwood County, MN"
2015,Feb,8172,7721,451,5.5,"Redwood County, MN"
2015,Mar,8435,7994,441,5.2,"Redwood County, MN"
2015,Apr,8157,7858,299,3.7,"Redwood County, MN"
2015,May,8189,7899,290,3.5,"Redwood County, MN"
2015,Jun,8573,8249,324,3.8,"Redwood County, MN"
2015,Jul,8336,8026,310,3.7,"Redwood County, MN"
2015,Aug,8174,7901,273,3.3,"Redwood County, MN"
2015,Sep,8018,7765,253,3.2,"Redwood County, MN"
2015,Oct,8386,8150,236,2.8,"Redwood County, MN"
2015,Nov,8277,8012,265,3.2,"Redwood County, MN"
2015,Dec,8464,8095,369,4.4,"Redwood County, MN"
2016,Jan,8441,7992,449,5.3,"Redwood County, MN"
2016,Feb,8210,7777,433,5.3,"Redwood County, MN"
2016,Mar,8424,7971,453,5.4,"Redwood County, MN"
2016,Apr,8286,7982,304,3.7,"Redwood County, MN"
2016,May,8230,7968,262,3.2,"Redwood County, MN"
2016,Jun,8446,8119,327,3.9,"Redwood County, MN"
2016,Jul,8355,8031,324,3.9,"Redwood County, MN"
2016,Aug,8198,7882,316,3.9,"Redwood County, MN"
2016,Sep,8099,7812,287,3.5,"Redwood County, MN"
2016,Oct,8307,8015,292,3.5,"Redwood County, MN"
2016,Nov,8350,8072,278,3.3,"Redwood County, MN"
2016,Dec,8436,8066,370,4.4,"Redwood County, MN"
2017,Jan,7874,7424,450,5.7,"Redwood County, MN"
2017,Feb,7758,7315,443,5.7,"Redwood County, MN"
2017,Mar,7829,7418,411,5.2,"Redwood County, MN"
2017,Apr,7767,7478,289,3.7,"Redwood County, MN"
2017,May,7714,7456,258,3.3,"Redwood County, MN"
2017,Jun,7865,7557,308,3.9,"Redwood County, MN"
2017,Jul,7761,7465,296,3.8,"Redwood County, MN"
2017,Aug,7453,7143,310,4.2,"Redwood County, MN"
2017,Sep,7451,7210,241,3.2,"Redwood County, MN"
2017,Oct,7690,7470,220,2.9,"Redwood County, MN"
2017,Nov,7616,7366,250,3.3,"Redwood County, MN"
2017,Dec,7761,7426,335,4.3,"Redwood County, MN"
2018,Jan,7485,7080,405,5.4,"Redwood County, MN"
2018,Feb,7535,7126,409,5.4,"Redwood County, MN"
2018,Mar,7590,7212,378,5.0,"Redwood County, MN"
2018,Apr,7650,7348,302,3.9,"Redwood County, MN"
2018,May,7751,7531,220,2.8,"Redwood County, MN"
2018,Jun,7832,7565,267,3.4,"Redwood County, MN"
2018,Jul,7755,7497,258,3.3,"Redwood County, MN"
2018,Aug,7373,7153,220,3.0,"Redwood County, MN"
2018,Sep,7505,7323,182,2.4,"Redwood County, MN"
2018,Oct,7598,7422,176,2.3,"Redwood County, MN"
2018,Nov,7595,7378,217,2.9,"Redwood County, MN"
2018,Dec,7762,7430,332,4.3,"Redwood County, MN"
2019,Jan,7520,7105,415,5.5,"Redwood County, MN"
2019,Feb,7481,7107,374,5.0,"Redwood County, MN"
2019,Mar,7534,7161,373,5.0,"Redwood County, MN"
2019,Apr,7603,7318,285,3.7,"Redwood County, MN"
2019,May,7750,7506,244,3.1,"Redwood County, MN"
2019,Jun,7887,7599,288,3.7,"Redwood County, MN"
2019,Jul,7806,7525,281,3.6,"Redwood County, MN"
2019,Aug,7515,7269,246,3.3,"Redwood County, MN"
2019,Sep,7608,7407,201,2.6,"Redwood County, MN"
2019,Oct,7733,7530,203,2.6,"Redwood County, MN"
2019,Nov,7560,7335,225,3.0,"Redwood County, MN"
2019,Dec,7726,7430,296,3.8,"Redwood County, MN"
2020,Jan,7459,7110,349,4.7,"Redwood County, MN"
2020,Feb,7496,7159,337,4.5,"Redwood County, MN"
2020,Mar,7499,7072,427,5.7,"Redwood County, MN"
2020,Apr,7815,7132,683,8.7,"Redwood County, MN"
2020,May,7828,7046,782,10.0,"Redwood County, MN"
2020,Jun,8082,7545,537,6.6,"Redwood County, MN"
2020,Jul,8205,7740,465,5.7,"Redwood County, MN"
2020,Aug,7946,7578,368,4.6,"Redwood County, MN"
2020,Sep,7807,7461,346,4.4,"Redwood County, MN"
2020,Oct,7977,7670,307,3.8,"Redwood County, MN"
2020,Nov,7717,7431,286,3.7,"Redwood County, MN"
2020,Dec,7859,7522,337,4.3,"Redwood County, MN"
2021,Jan,7563,7162,401,5.3,"Redwood County, MN"
2021,Feb,7571,7173,398,5.3,"Redwood County, MN"
2021,Mar,7500,7078,422,5.6,"Redwood County, MN"
2021,Apr,7454,7172,282,3.8,"Redwood County, MN"
2021,May,7551,7304,247,3.3,"Redwood County, MN"
2021,Jun,7790,7489,301,3.9,"Redwood County, MN"
2021,Jul,7729,7463,266,3.4,"Redwood County, MN"
2021,Aug,7554,7326,228,3.0,"Redwood County, MN"
2021,Sep,7409,7213,196,2.6,"Redwood County, MN"
2021,Oct,7543,7372,171,2.3,"Redwood County, MN"
2021,Nov,7454,7290,164,2.2,"Redwood County, MN"
2021,Dec,7822,7610,212,2.7,"Redwood County, MN"
2022,Jan,7578,7295,283,3.7,"Redwood County, MN"
2022,Feb,7546,7309,237,3.1,"Redwood County, MN"
2022,Mar,7575,7353,222,2.9,"Redwood County, MN"
2022,Apr,7447,7282,165,2.2,"Redwood County, MN"
2022,May,7536,7394,142,1.9,"Redwood County, MN"
2022,Jun,7706,7512,194,2.5,"Redwood County, MN"
2022,Jul,7752,7558,194,2.5,"Redwood County, MN"
2022,Aug,7569,7380,189,2.5,"Redwood County, MN"
2022,Sep,7481,7344,137,1.8,"Redwood County, MN"
2022,Oct,7527,7384,143,1.9,"Redwood County, MN"
2022,Nov,7421,7261,160,2.2,"Redwood County, MN"
2022,Dec,7805,7580,225,2.9,"Redwood County, MN"
2023,Jan,7577,7307,270,3.6,"Redwood County, MN"
2023,Feb,7580,7313,267,3.5,"Redwood County, MN"
2023,Mar,7395,7138,257,3.5,"Redwood County, MN"
2023,Apr,7433,7217,216,2.9,"Redwood County, MN"
2023,May,7429,7230,199,2.7,"Redwood County, MN"
2023,Jun,7635,7362,273,3.6,"Redwood County, MN"
2023,Jul,7566,7305,261,3.4,"Redwood County, MN"
2023,Aug,7727,7483,244,3.2,"Redwood County, MN"
2023,Sep,7744,7567,177,2.3,"Redwood County, MN"
2023,Oct,7746,7583,163,2.1,"Redwood County, MN"
2023,Nov,7710,7570,140,1.8,"Redwood County, MN"
2023,Dec,7692,7510,182,2.4,"Redwood County, MN"
2024,Jan,7539,7299,240,3.2,"Redwood County, MN"
2024,Feb,7524,7261,263,3.5,"Redwood County, MN"
2024,Mar,7689,7473,216,2.8,"Redwood County, MN"
2024,Apr,7711,7530,181,2.3,"Redwood County, MN"
2024,May,7546,7354,192,2.5,"Redwood County, MN"
2024,Jun,7949,7635,314,4.0,"Redwood County, MN"
2024,Jul,7980,7636,344,4.3,"Redwood County, MN"
2024,Aug,8130,7832,298,3.7,"Redwood County, MN"
2024,Sep,8041,7845,196,2.4,"Redwood County, MN"
2024,Oct,7961,7777,184,2.3,"Redwood County, MN"
2024,Nov,7989(P),7779(P),210(P),2.6(P),"Redwood County, MN"
P : Preliminary.,P : Preliminary.,P : Preliminary.,P : Preliminary.,P : Preliminary.,P : Preliminary.,"Redwood County, MN"
2014,Jan,8147,7509,638,7.8,"Renville County, MN"
2014,Feb,8046,7434,612,7.6,"Renville County, MN"
2014,Mar,8154,7543,611,7.5,"Renville County, MN"
2014,Apr,7985,7465,520,6.5,"Renville County, MN"
2014,May,7913,7486,427,5.4,"Renville County, MN"
2014,Jun,8165,7706,459,5.6,"Renville County, MN"
2014,Jul,8240,7806,434,5.3,"Renville County, MN"
2014,Aug,8265,7854,411,5.0,"Renville County, MN"
2014,Sep,8194,7859,335,4.1,"Renville County, MN"
2014,Oct,8696,8386,310,3.6,"Renville County, MN"
2014,Nov,8437,8075,362,4.3,"Renville County, MN"
2014,Dec,8491,8036,455,5.4,"Renville County, MN"
2015,Jan,8632,8072,560,6.5,"Renville County, MN"
2015,Feb,8378,7859,519,6.2,"Renville County, MN"
2015,Mar,8732,8164,568,6.5,"Renville County, MN"
2015,Apr,8484,8066,418,4.9,"Renville County, MN"
2015,May,8428,8035,393,4.7,"Renville County, MN"
2015,Jun,8779,8339,440,5.0,"Renville County, MN"
2015,Jul,8490,8092,398,4.7,"Renville County, MN"
2015,Aug,8438,8094,344,4.1,"Renville County, MN"
2015,Sep,8382,8078,304,3.6,"Renville County, MN"
2015,Oct,9126,8825,301,3.3,"Renville County, MN"
2015,Nov,8771,8417,354,4.0,"Renville County, MN"
2015,Dec,8735,8263,472,5.4,"Renville County, MN"
2016,Jan,8853,8308,545,6.2,"Renville County, MN"
2016,Feb,8504,7976,528,6.2,"Renville County, MN"
2016,Mar,8694,8160,534,6.1,"Renville County, MN"
2016,Apr,8263,7836,427,5.2,"Renville County, MN"
2016,May,8078,7677,401,5.0,"Renville County, MN"
2016,Jun,8121,7627,494,6.1,"Renville County, MN"
2016,Jul,7995,7543,452,5.7,"Renville County, MN"
2016,Aug,8322,7898,424,5.1,"Renville County, MN"
2016,Sep,8199,7851,348,4.2,"Renville County, MN"
2016,Oct,8922,8586,336,3.8,"Renville County, MN"
2016,Nov,8593,8245,348,4.0,"Renville County, MN"
2016,Dec,8381,7916,465,5.5,"Renville County, MN"
2017,Jan,9147,8557,590,6.5,"Renville County, MN"
2017,Feb,8874,8337,537,6.1,"Renville County, MN"
2017,Mar,9011,8480,531,5.9,"Renville County, MN"
2017,Apr,8965,8552,413,4.6,"Renville County, MN"
2017,May,8829,8455,374,4.2,"Renville County, MN"
2017,Jun,8770,8347,423,4.8,"Renville County, MN"
2017,Jul,8692,8304,388,4.5,"Renville County, MN"
2017,Aug,8612,8248,364,4.2,"Renville County, MN"
2017,Sep,8698,8444,254,2.9,"Renville County, MN"
2017,Oct,9363,9129,234,2.5,"Renville County, MN"
2017,Nov,9217,8941,276,3.0,"Renville County, MN"
2017,Dec,8863,8472,391,4.4,"Renville County, MN"
2018,Jan,8619,8124,495,5.7,"Renville County, MN"
2018,Feb,8642,8159,483,5.6,"Renville County, MN"
2018,Mar,8705,8202,503,5.8,"Renville County, MN"
2018,Apr,8710,8310,400,4.6,"Renville County, MN"
2018,May,8856,8549,307,3.5,"Renville County, MN"
2018,Jun,8772,8404,368,4.2,"Renville County, MN"
2018,Jul,8600,8272,328,3.8,"Renville County, MN"
2018,Aug,8413,8098,315,3.7,"Renville County, MN"
2018,Sep,8691,8471,220,2.5,"Renville County, MN"
2018,Oct,9148,8942,206,2.3,"Renville County, MN"
2018,Nov,8853,8628,225,2.5,"Renville County, MN"
2018,Dec,8692,8287,405,4.7,"Renville County, MN"
2019,Jan,8492,7934,558,6.6,"Renville County, MN"
2019,Feb,8389,7883,506,6.0,"Renville County, MN"
2019,Mar,8526,8004,522,6.1,"Renville County, MN"
2019,Apr,8624,8152,472,5.5,"Renville County, MN"
2019,May,8835,8477,358,4.1,"Renville County, MN"
2019,Jun,8746,8365,381,4.4,"Renville County, MN"
2019,Jul,8659,8277,382,4.4,"Renville County, MN"
2019,Aug,8484,8150,334,3.9,"Renville County, MN"
2019,Sep,8649,8393,256,3.0,"Renville County, MN"
2019,Oct,9300,9042,258,2.8,"Renville County, MN"
2019,Nov,8718,8434,284,3.3,"Renville County, MN"
2019,Dec,8725,8267,458,5.2,"Renville County, MN"
2020,Jan,8172,7625,547,6.7,"Renville County, MN"
2020,Feb,8160,7628,532,6.5,"Renville County, MN"
2020,Mar,8220,7577,643,7.8,"Renville County, MN"
2020,Apr,7912,7306,606,7.7,"Renville County, MN"
2020,May,7938,7220,718,9.0,"Renville County, MN"
2020,Jun,8696,8101,595,6.8,"Renville County, MN"
2020,Jul,8809,8291,518,5.9,"Renville County, MN"
2020,Aug,8779,8401,378,4.3,"Renville County, MN"
2020,Sep,8781,8446,335,3.8,"Renville County, MN"
2020,Oct,9471,9155,316,3.3,"Renville County, MN"
2020,Nov,8745,8411,334,3.8,"Renville County, MN"
2020,Dec,8729,8315,414,4.7,"Renville County, MN"
2021,Jan,8340,7826,514,6.2,"Renville County, MN"
2021,Feb,8308,7824,484,5.8,"Renville County, MN"
2021,Mar,8257,7766,491,5.9,"Renville County, MN"
2021,Apr,8244,7866,378,4.6,"Renville County, MN"
2021,May,8237,7906,331,4.0,"Renville County, MN"
2021,Jun,8297,7903,394,4.7,"Renville County, MN"
2021,Jul,8427,8082,345,4.1,"Renville County, MN"
2021,Aug,8244,7952,292,3.5,"Renville County, MN"
2021,Sep,8287,8044,243,2.9,"Renville County, MN"
2021,Oct,8652,8461,191,2.2,"Renville County, MN"
2021,Nov,8431,8209,222,2.6,"Renville County, MN"
2021,Dec,8321,8035,286,3.4,"Renville County, MN"
2022,Jan,8124,7721,403,5.0,"Renville County, MN"
2022,Feb,8174,7782,392,4.8,"Renville County, MN"
2022,Mar,8082,7724,358,4.4,"Renville County, MN"
2022,Apr,7934,7682,252,3.2,"Renville County, MN"
2022,May,8054,7843,211,2.6,"Renville County, MN"
2022,Jun,7962,7690,272,3.4,"Renville County, MN"
2022,Jul,8034,7766,268,3.3,"Renville County, MN"
2022,Aug,7998,7726,272,3.4,"Renville County, MN"
2022,Sep,8162,7953,209,2.6,"Renville County, MN"
2022,Oct,8541,8363,178,2.1,"Renville County, MN"
2022,Nov,8286,8088,198,2.4,"Renville County, MN"
2022,Dec,8253,7935,318,3.9,"Renville County, MN"
2023,Jan,8163,7770,393,4.8,"Renville County, MN"
2023,Feb,8163,7753,410,5.0,"Renville County, MN"
2023,Mar,8129,7745,384,4.7,"Renville County, MN"
2023,Apr,7969,7649,320,4.0,"Renville County, MN"
2023,May,7851,7570,281,3.6,"Renville County, MN"
2023,Jun,7937,7588,349,4.4,"Renville County, MN"
2023,Jul,7657,7343,314,4.1,"Renville County, MN"
2023,Aug,8248,7932,316,3.8,"Renville County, MN"
2023,Sep,8219,8025,194,2.4,"Renville County, MN"
2023,Oct,8566,8395,171,2.0,"Renville County, MN"
2023,Nov,8409,8231,178,2.1,"Renville County, MN"
2023,Dec,7947,7660,287,3.6,"Renville County, MN"
2024,Jan,7882,7499,383,4.9,"Renville County, MN"
2024,Feb,7867,7437,430,5.5,"Renville County, MN"
2024,Mar,8050,7661,389,4.8,"Renville County, MN"
2024,Apr,8027,7704,323,4.0,"Renville County, MN"
2024,May,7745,7449,296,3.8,"Renville County, MN"
2024,Jun,8130,7692,438,5.4,"Renville County, MN"
2024,Jul,8078,7665,413,5.1,"Renville County, MN"
2024,Aug,8541,8186,355,4.2,"Renville County, MN"
2024,Sep,8640,8393,247,2.9,"Renville County, MN"
2024,Oct,8693,8466,227,2.6,"Renville County, MN"
2024,Nov,8632(P),8342(P),290(P),3.4(P),"Renville County, MN"
P : Preliminary.,P : Preliminary.,P : Preliminary.,P : Preliminary.,P : Preliminary.,P : Preliminary.,"Renville County, MN"
2014,Jan,34834,32940,1894,5.4,"Rice County, MN"
2014,Feb,34921,33041,1880,5.4,"Rice County, MN"
2014,Mar,34927,33077,1850,5.3,"Rice County, MN"
2014,Apr,35104,33571,1533,4.4,"Rice County, MN"
2014,May,35383,34021,1362,3.8,"Rice County, MN"
2014,Jun,35768,34198,1570,4.4,"Rice County, MN"
2014,Jul,35382,33831,1551,4.4,"Rice County, MN"
2014,Aug,34944,33552,1392,4.0,"Rice County, MN"
2014,Sep,35056,33845,1211,3.5,"Rice County, MN"
2014,Oct,35362,34271,1091,3.1,"Rice County, MN"
2014,Nov,35266,34162,1104,3.1,"Rice County, MN"
2014,Dec,35282,33937,1345,3.8,"Rice County, MN"
2015,Jan,35059,33476,1583,4.5,"Rice County, MN"
2015,Feb,35181,33669,1512,4.3,"Rice County, MN"
2015,Mar,35285,33802,1483,4.2,"Rice County, MN"
2015,Apr,35579,34432,1147,3.2,"Rice County, MN"
2015,May,35818,34696,1122,3.1,"Rice County, MN"
2015,Jun,36171,34755,1416,3.9,"Rice County, MN"
2015,Jul,35490,34093,1397,3.9,"Rice County, MN"
2015,Aug,35111,33824,1287,3.7,"Rice County, MN"
2015,Sep,35565,34443,1122,3.2,"Rice County, MN"
2015,Oct,35518,34475,1043,2.9,"Rice County, MN"
2015,Nov,35555,34565,990,2.8,"Rice County, MN"
2015,Dec,35747,34435,1312,3.7,"Rice County, MN"
2016,Jan,35853,34345,1508,4.2,"Rice County, MN"
2016,Feb,36080,34571,1509,4.2,"Rice County, MN"
2016,Mar,36135,34646,1489,4.1,"Rice County, MN"
2016,Apr,36097,34940,1157,3.2,"Rice County, MN"
2016,May,36086,35046,1040,2.9,"Rice County, MN"
2016,Jun,36538,35152,1386,3.8,"Rice County, MN"
2016,Jul,36039,34736,1303,3.6,"Rice County, MN"
2016,Aug,35855,34590,1265,3.5,"Rice County, MN"
2016,Sep,36334,35209,1125,3.1,"Rice County, MN"
2016,Oct,36022,34956,1066,3.0,"Rice County, MN"
2016,Nov,35976,34992,984,2.7,"Rice County, MN"
2016,Dec,35984,34635,1349,3.7,"Rice County, MN"
2017,Jan,36426,34876,1550,4.3,"Rice County, MN"
2017,Feb,36638,35120,1518,4.1,"Rice County, MN"
2017,Mar,36844,35400,1444,3.9,"Rice County, MN"
2017,Apr,36569,35437,1132,3.1,"Rice County, MN"
2017,May,36612,35572,1040,2.8,"Rice County, MN"
2017,Jun,37284,36004,1280,3.4,"Rice County, MN"
2017,Jul,36690,35488,1202,3.3,"Rice County, MN"
2017,Aug,36676,35435,1241,3.4,"Rice County, MN"
2017,Sep,37003,36036,967,2.6,"Rice County, MN"
2017,Oct,36554,35768,786,2.2,"Rice County, MN"
2017,Nov,36506,35664,842,2.3,"Rice County, MN"
2017,Dec,36532,35411,1121,3.1,"Rice County, MN"
2018,Jan,36519,35203,1316,3.6,"Rice County, MN"
2018,Feb,36973,35668,1305,3.5,"Rice County, MN"
2018,Mar,36973,35685,1288,3.5,"Rice County, MN"
2018,Apr,37086,36059,1027,2.8,"Rice County, MN"
2018,May,37041,36206,835,2.3,"Rice County, MN"
2018,Jun,37556,36447,1109,3.0,"Rice County, MN"
2018,Jul,36957,35909,1048,2.8,"Rice County, MN"
2018,Aug,36425,35390,1035,2.8,"Rice County, MN"
2018,Sep,36785,35922,863,2.3,"Rice County, MN"
2018,Oct,36903,36117,786,2.1,"Rice County, MN"
2018,Nov,37011,36214,797,2.2,"Rice County, MN"
2018,Dec,37128,35889,1239,3.3,"Rice County, MN"
2019,Jan,37065,35586,1479,4.0,"Rice County, MN"
2019,Feb,37107,35693,1414,3.8,"Rice County, MN"
2019,Mar,37148,35724,1424,3.8,"Rice County, MN"
2019,Apr,37211,36132,1079,2.9,"Rice County, MN"
2019,May,37355,36364,991,2.7,"Rice County, MN"
2019,Jun,38018,36719,1299,3.4,"Rice County, MN"
2019,Jul,37534,36293,1241,3.3,"Rice County, MN"
2019,Aug,37231,36049,1182,3.2,"Rice County, MN"
2019,Sep,37499,36559,940,2.5,"Rice County, MN"
2019,Oct,37655,36797,858,2.3,"Rice County, MN"
2019,Nov,37396,36515,881,2.4,"Rice County, MN"
2019,Dec,37634,36290,1344,3.6,"Rice County, MN"
2020,Jan,37814,36309,1505,4.0,"Rice County, MN"
2020,Feb,37931,36507,1424,3.8,"Rice County, MN"
2020,Mar,37855,35995,1860,4.9,"Rice County, MN"
2020,Apr,35964,33465,2499,6.9,"Rice County, MN"
2020,May,36565,33347,3218,8.8,"Rice County, MN"
2020,Jun,37962,35096,2866,7.5,"Rice County, MN"
2020,Jul,38095,35563,2532,6.6,"Rice County, MN"
2020,Aug,38191,36205,1986,5.2,"Rice County, MN"
2020,Sep,37491,35785,1706,4.6,"Rice County, MN"
2020,Oct,37821,36367,1454,3.8,"Rice County, MN"
2020,Nov,37440,36052,1388,3.7,"Rice County, MN"
2020,Dec,36942,35227,1715,4.6,"Rice County, MN"
2021,Jan,36997,35197,1800,4.9,"Rice County, MN"
2021,Feb,37136,35467,1669,4.5,"Rice County, MN"
2021,Mar,37234,35651,1583,4.3,"Rice County, MN"
2021,Apr,37212,35846,1366,3.7,"Rice County, MN"
2021,May,37264,36108,1156,3.1,"Rice County, MN"
2021,Jun,37452,35972,1480,4.0,"Rice County, MN"
2021,Jul,37229,35956,1273,3.4,"Rice County, MN"
2021,Aug,37168,35923,1245,3.3,"Rice County, MN"
2021,Sep,36988,35962,1026,2.8,"Rice County, MN"
2021,Oct,37363,36460,903,2.4,"Rice County, MN"
2021,Nov,37346,36510,836,2.2,"Rice County, MN"
2021,Dec,37493,36404,1089,2.9,"Rice County, MN"
2022,Jan,37345,36018,1327,3.6,"Rice County, MN"
2022,Feb,37411,36251,1160,3.1,"Rice County, MN"
2022,Mar,37559,36452,1107,2.9,"Rice County, MN"
2022,Apr,37576,36793,783,2.1,"Rice County, MN"
2022,May,37669,36968,701,1.9,"Rice County, MN"
2022,Jun,37536,36592,944,2.5,"Rice County, MN"
2022,Jul,37468,36586,882,2.4,"Rice County, MN"
2022,Aug,37624,36719,905,2.4,"Rice County, MN"
2022,Sep,37429,36768,661,1.8,"Rice County, MN"
2022,Oct,37295,36605,690,1.9,"Rice County, MN"
2022,Nov,37440,36652,788,2.1,"Rice County, MN"
2022,Dec,37499,36362,1137,3.0,"Rice County, MN"
2023,Jan,37525,36304,1221,3.3,"Rice County, MN"
2023,Feb,37841,36540,1301,3.4,"Rice County, MN"
2023,Mar,37965,36723,1242,3.3,"Rice County, MN"
2023,Apr,38020,37064,956,2.5,"Rice County, MN"
2023,May,38172,37342,830,2.2,"Rice County, MN"
2023,Jun,38358,37226,1132,3.0,"Rice County, MN"
2023,Jul,38025,36997,1028,2.7,"Rice County, MN"
2023,Aug,38094,36990,1104,2.9,"Rice County, MN"
2023,Sep,37787,37063,724,1.9,"Rice County, MN"
2023,Oct,37844,37145,699,1.8,"Rice County, MN"
2023,Nov,37789,37178,611,1.6,"Rice County, MN"
2023,Dec,37526,36611,915,2.4,"Rice County, MN"
2024,Jan,37799,36621,1178,3.1,"Rice County, MN"
2024,Feb,38060,36740,1320,3.5,"Rice County, MN"
2024,Mar,38176,37017,1159,3.0,"Rice County, MN"
2024,Apr,38238,37318,920,2.4,"Rice County, MN"
2024,May,38135,37152,983,2.6,"Rice County, MN"
2024,Jun,38271,36840,1431,3.7,"Rice County, MN"
2024,Jul,38049,36691,1358,3.6,"Rice County, MN"
2024,Aug,38255,36817,1438,3.8,"Rice County, MN"
2024,Sep,38007,37108,899,2.4,"Rice County, MN"
2024,Oct,38205,37403,802,2.1,"Rice County, MN"
2024,Nov,38198(P),37250(P),948(P),2.5(P),"Rice County, MN"
P : Preliminary.,P : Preliminary.,P : Preliminary.,P : Preliminary.,P : Preliminary.,P : Preliminary.,"Rice County, MN"
2014,Jan,5635,5438,197,3.5,"Rock County, MN"
2014,Feb,5593,5402,191,3.4,"Rock County, MN"
2014,Mar,5609,5430,179,3.2,"Rock County, MN"
2014,Apr,5583,5445,138,2.5,"Rock County, MN"
2014,May,5632,5490,142,2.5,"Rock County, MN"
2014,Jun,5736,5581,155,2.7,"Rock County, MN"
2014,Jul,5719,5567,152,2.7,"Rock County, MN"
2014,Aug,5688,5554,134,2.4,"Rock County, MN"
2014,Sep,5674,5557,117,2.1,"Rock County, MN"
2014,Oct,5786,5667,119,2.1,"Rock County, MN"
2014,Nov,5744,5632,112,1.9,"Rock County, MN"
2014,Dec,5794,5662,132,2.3,"Rock County, MN"
2015,Jan,5895,5724,171,2.9,"Rock County, MN"
2015,Feb,5792,5627,165,2.8,"Rock County, MN"
2015,Mar,5909,5750,159,2.7,"Rock County, MN"
2015,Apr,5819,5705,114,2.0,"Rock County, MN"
2015,May,5834,5715,119,2.0,"Rock County, MN"
2015,Jun,6021,5888,133,2.2,"Rock County, MN"
2015,Jul,5920,5792,128,2.2,"Rock County, MN"
2015,Aug,5863,5753,110,1.9,"Rock County, MN"
2015,Sep,5850,5752,98,1.7,"Rock County, MN"
2015,Oct,6057,5954,103,1.7,"Rock County, MN"
2015,Nov,5998,5892,106,1.8,"Rock County, MN"
2015,Dec,6084,5952,132,2.2,"Rock County, MN"
2016,Jan,6057,5880,177,2.9,"Rock County, MN"
2016,Feb,5860,5692,168,2.9,"Rock County, MN"
2016,Mar,5998,5836,162,2.7,"Rock County, MN"
2016,Apr,5903,5777,126,2.1,"Rock County, MN"
2016,May,5876,5753,123,2.1,"Rock County, MN"
2016,Jun,5952,5811,141,2.4,"Rock County, MN"
2016,Jul,5824,5697,127,2.2,"Rock County, MN"
2016,Aug,5785,5661,124,2.1,"Rock County, MN"
2016,Sep,5749,5634,115,2.0,"Rock County, MN"
2016,Oct,5952,5829,123,2.1,"Rock County, MN"
2016,Nov,5970,5860,110,1.8,"Rock County, MN"
2016,Dec,5954,5808,146,2.5,"Rock County, MN"
2017,Jan,6003,5834,169,2.8,"Rock County, MN"
2017,Feb,5877,5718,159,2.7,"Rock County, MN"
2017,Mar,5937,5801,136,2.3,"Rock County, MN"
2017,Apr,5964,5854,110,1.8,"Rock County, MN"
2017,May,5934,5824,110,1.9,"Rock County, MN"
2017,Jun,5959,5827,132,2.2,"Rock County, MN"
2017,Jul,5842,5715,127,2.2,"Rock County, MN"
2017,Aug,5684,5564,120,2.1,"Rock County, MN"
2017,Sep,5810,5705,105,1.8,"Rock County, MN"
2017,Oct,5954,5860,94,1.6,"Rock County, MN"
2017,Nov,5890,5780,110,1.9,"Rock County, MN"
2017,Dec,5925,5801,124,2.1,"Rock County, MN"
2018,Jan,5691,5506,185,3.3,"Rock County, MN"
2018,Feb,5670,5488,182,3.2,"Rock County, MN"
2018,Mar,5675,5503,172,3.0,"Rock County, MN"
2018,Apr,5705,5564,141,2.5,"Rock County, MN"
2018,May,5823,5703,120,2.1,"Rock County, MN"
2018,Jun,5853,5703,150,2.6,"Rock County, MN"
2018,Jul,5774,5648,126,2.2,"Rock County, MN"
2018,Aug,5510,5405,105,1.9,"Rock County, MN"
2018,Sep,5643,5542,101,1.8,"Rock County, MN"
2018,Oct,5710,5610,100,1.8,"Rock County, MN"
2018,Nov,5655,5559,96,1.7,"Rock County, MN"
2018,Dec,5708,5567,141,2.5,"Rock County, MN"
2019,Jan,5553,5391,162,2.9,"Rock County, MN"
2019,Feb,5504,5360,144,2.6,"Rock County, MN"
2019,Mar,5571,5415,156,2.8,"Rock County, MN"
2019,Apr,5670,5553,117,2.1,"Rock County, MN"
2019,May,5792,5677,115,2.0,"Rock County, MN"
2019,Jun,5817,5675,142,2.4,"Rock County, MN"
2019,Jul,5745,5616,129,2.2,"Rock County, MN"
2019,Aug,5542,5415,127,2.3,"Rock County, MN"
2019,Sep,5671,5563,108,1.9,"Rock County, MN"
2019,Oct,5806,5694,112,1.9,"Rock County, MN"
2019,Nov,5680,5567,113,2.0,"Rock County, MN"
2019,Dec,5736,5590,146,2.5,"Rock County, MN"
2020,Jan,5520,5362,158,2.9,"Rock County, MN"
2020,Feb,5520,5373,147,2.7,"Rock County, MN"
2020,Mar,5520,5348,172,3.1,"Rock County, MN"
2020,Apr,5595,5389,206,3.7,"Rock County, MN"
2020,May,5582,5296,286,5.1,"Rock County, MN"
2020,Jun,6000,5738,262,4.4,"Rock County, MN"
2020,Jul,6121,5889,232,3.8,"Rock County, MN"
2020,Aug,6073,5899,174,2.9,"Rock County, MN"
2020,Sep,6012,5862,150,2.5,"Rock County, MN"
2020,Oct,6228,6093,135,2.2,"Rock County, MN"
2020,Nov,6121,6002,119,1.9,"Rock County, MN"
2020,Dec,6091,5939,152,2.5,"Rock County, MN"
2021,Jan,5881,5712,169,2.9,"Rock County, MN"
2021,Feb,5866,5712,154,2.6,"Rock County, MN"
2021,Mar,5836,5686,150,2.6,"Rock County, MN"
2021,Apr,5818,5712,106,1.8,"Rock County, MN"
2021,May,5900,5791,109,1.8,"Rock County, MN"
2021,Jun,5985,5838,147,2.5,"Rock County, MN"
2021,Jul,5977,5859,118,2.0,"Rock County, MN"
2021,Aug,5887,5768,119,2.0,"Rock County, MN"
2021,Sep,5961,5859,102,1.7,"Rock County, MN"
2021,Oct,6091,6005,86,1.4,"Rock County, MN"
2021,Nov,6004,5923,81,1.3,"Rock County, MN"
2021,Dec,6090,5989,101,1.7,"Rock County, MN"
2022,Jan,6007,5865,142,2.4,"Rock County, MN"
2022,Feb,5978,5854,124,2.1,"Rock County, MN"
2022,Mar,6034,5915,119,2.0,"Rock County, MN"
2022,Apr,5926,5858,68,1.1,"Rock County, MN"
2022,May,5981,5916,65,1.1,"Rock County, MN"
2022,Jun,6052,5953,99,1.6,"Rock County, MN"
2022,Jul,6046,5951,95,1.6,"Rock County, MN"
2022,Aug,5938,5841,97,1.6,"Rock County, MN"
2022,Sep,5964,5892,72,1.2,"Rock County, MN"
2022,Oct,6060,5982,78,1.3,"Rock County, MN"
2022,Nov,5941,5858,83,1.4,"Rock County, MN"
2022,Dec,6037,5923,114,1.9,"Rock County, MN"
2023,Jan,5954,5815,139,2.3,"Rock County, MN"
2023,Feb,5947,5813,134,2.3,"Rock County, MN"
2023,Mar,5984,5858,126,2.1,"Rock County, MN"
2023,Apr,5898,5796,102,1.7,"Rock County, MN"
2023,May,5938,5845,93,1.6,"Rock County, MN"
2023,Jun,6012,5861,151,2.5,"Rock County, MN"
2023,Jul,5902,5767,135,2.3,"Rock County, MN"
2023,Aug,6000,5874,126,2.1,"Rock County, MN"
2023,Sep,5979,5888,91,1.5,"Rock County, MN"
2023,Oct,6051,5967,84,1.4,"Rock County, MN"
2023,Nov,6009,5947,62,1.0,"Rock County, MN"
2023,Dec,5893,5814,79,1.3,"Rock County, MN"
2024,Jan,5830,5715,115,2.0,"Rock County, MN"
2024,Feb,5808,5678,130,2.2,"Rock County, MN"
2024,Mar,5928,5836,92,1.6,"Rock County, MN"
2024,Apr,5911,5840,71,1.2,"Rock County, MN"
2024,May,5814,5732,82,1.4,"Rock County, MN"
2024,Jun,6026,5861,165,2.7,"Rock County, MN"
2024,Jul,6021,5844,177,2.9,"Rock County, MN"
2024,Aug,6128,5973,155,2.5,"Rock County, MN"
2024,Sep,6124,6026,98,1.6,"Rock County, MN"
2024,Oct,6123,6040,83,1.4,"Rock County, MN"
2024,Nov,6095(P),6002(P),93(P),1.5(P),"Rock County, MN"
P : Preliminary.,P : Preliminary.,P : Preliminary.,P : Preliminary.,P : Preliminary.,P : Preliminary.,"Rock County, MN"
2014,Jan,8891,8397,494,5.6,"Roseau County, MN"
2014,Feb,8874,8404,470,5.3,"Roseau County, MN"
2014,Mar,8844,8439,405,4.6,"Roseau County, MN"
2014,Apr,8741,8414,327,3.7,"Roseau County, MN"
2014,May,8714,8424,290,3.3,"Roseau County, MN"
2014,Jun,8843,8514,329,3.7,"Roseau County, MN"
2014,Jul,8852,8528,324,3.7,"Roseau County, MN"
2014,Aug,8766,8481,285,3.3,"Roseau County, MN"
2014,Sep,8756,8514,242,2.8,"Roseau County, MN"
2014,Oct,8888,8659,229,2.6,"Roseau County, MN"
2014,Nov,8838,8608,230,2.6,"Roseau County, MN"
2014,Dec,8964,8603,361,4.0,"Roseau County, MN"
2015,Jan,8683,8238,445,5.1,"Roseau County, MN"
2015,Feb,8635,8185,450,5.2,"Roseau County, MN"
2015,Mar,8633,8238,395,4.6,"Roseau County, MN"
2015,Apr,8489,8181,308,3.6,"Roseau County, MN"
2015,May,8400,8100,300,3.6,"Roseau County, MN"
2015,Jun,8459,8114,345,4.1,"Roseau County, MN"
2015,Jul,8239,7929,310,3.8,"Roseau County, MN"
2015,Aug,8139,7854,285,3.5,"Roseau County, MN"
2015,Sep,8184,7924,260,3.2,"Roseau County, MN"
2015,Oct,9067,8828,239,2.6,"Roseau County, MN"
2015,Nov,9253,8935,318,3.4,"Roseau County, MN"
2015,Dec,9295,8752,543,5.8,"Roseau County, MN"
2016,Jan,8548,8001,547,6.4,"Roseau County, MN"
2016,Feb,8580,7920,660,7.7,"Roseau County, MN"
2016,Mar,8585,7948,637,7.4,"Roseau County, MN"
2016,Apr,8265,7854,411,5.0,"Roseau County, MN"
2016,May,8219,7905,314,3.8,"Roseau County, MN"
2016,Jun,8259,7881,378,4.6,"Roseau County, MN"
2016,Jul,8031,7693,338,4.2,"Roseau County, MN"
2016,Aug,7974,7646,328,4.1,"Roseau County, MN"
2016,Sep,7981,7718,263,3.3,"Roseau County, MN"
2016,Oct,8039,7776,263,3.3,"Roseau County, MN"
2016,Nov,8112,7775,337,4.2,"Roseau County, MN"
2016,Dec,8341,7752,589,7.1,"Roseau County, MN"
2017,Jan,8674,7728,946,10.9,"Roseau County, MN"
2017,Feb,8410,7741,669,8.0,"Roseau County, MN"
2017,Mar,8228,7780,448,5.4,"Roseau County, MN"
2017,Apr,8128,7751,377,4.6,"Roseau County, MN"
2017,May,8120,7829,291,3.6,"Roseau County, MN"
2017,Jun,8250,7919,331,4.0,"Roseau County, MN"
2017,Jul,8034,7729,305,3.8,"Roseau County, MN"
2017,Aug,7886,7581,305,3.9,"Roseau County, MN"
2017,Sep,7975,7727,248,3.1,"Roseau County, MN"
2017,Oct,8063,7850,213,2.6,"Roseau County, MN"
2017,Nov,8172,7839,333,4.1,"Roseau County, MN"
2017,Dec,8198,7840,358,4.4,"Roseau County, MN"
2018,Jan,8069,7629,440,5.5,"Roseau County, MN"
2018,Feb,8021,7680,341,4.3,"Roseau County, MN"
2018,Mar,8054,7686,368,4.6,"Roseau County, MN"
2018,Apr,8008,7681,327,4.1,"Roseau County, MN"
2018,May,7946,7737,209,2.6,"Roseau County, MN"
2018,Jun,8083,7810,273,3.4,"Roseau County, MN"
2018,Jul,7796,7558,238,3.1,"Roseau County, MN"
2018,Aug,7594,7371,223,2.9,"Roseau County, MN"
2018,Sep,7722,7548,174,2.3,"Roseau County, MN"
2018,Oct,7780,7617,163,2.1,"Roseau County, MN"
2018,Nov,7813,7598,215,2.8,"Roseau County, MN"
2018,Dec,7913,7612,301,3.8,"Roseau County, MN"
2019,Jan,7931,7457,474,6.0,"Roseau County, MN"
2019,Feb,7869,7477,392,5.0,"Roseau County, MN"
2019,Mar,7936,7548,388,4.9,"Roseau County, MN"
2019,Apr,7785,7521,264,3.4,"Roseau County, MN"
2019,May,7937,7690,247,3.1,"Roseau County, MN"
2019,Jun,7989,7673,316,4.0,"Roseau County, MN"
2019,Jul,7859,7516,343,4.4,"Roseau County, MN"
2019,Aug,7768,7450,318,4.1,"Roseau County, MN"
2019,Sep,7807,7593,214,2.7,"Roseau County, MN"
2019,Oct,7846,7641,205,2.6,"Roseau County, MN"
2019,Nov,7817,7602,215,2.8,"Roseau County, MN"
2019,Dec,8000,7669,331,4.1,"Roseau County, MN"
2020,Jan,7892,7497,395,5.0,"Roseau County, MN"
2020,Feb,7913,7492,421,5.3,"Roseau County, MN"
2020,Mar,7890,7486,404,5.1,"Roseau County, MN"
2020,Apr,7866,7213,653,8.3,"Roseau County, MN"
2020,May,7974,7203,771,9.7,"Roseau County, MN"
2020,Jun,8344,7529,815,9.8,"Roseau County, MN"
2020,Jul,8024,7493,531,6.6,"Roseau County, MN"
2020,Aug,7844,7499,345,4.4,"Roseau County, MN"
2020,Sep,7885,7593,292,3.7,"Roseau County, MN"
2020,Oct,8044,7774,270,3.4,"Roseau County, MN"
2020,Nov,7966,7656,310,3.9,"Roseau County, MN"
2020,Dec,7969,7641,328,4.1,"Roseau County, MN"
2021,Jan,7904,7559,345,4.4,"Roseau County, MN"
2021,Feb,7936,7617,319,4.0,"Roseau County, MN"
2021,Mar,7908,7602,306,3.9,"Roseau County, MN"
2021,Apr,7871,7617,254,3.2,"Roseau County, MN"
2021,May,7914,7684,230,2.9,"Roseau County, MN"
2021,Jun,8000,7718,282,3.5,"Roseau County, MN"
2021,Jul,7893,7660,233,3.0,"Roseau County, MN"
2021,Aug,7850,7611,239,3.0,"Roseau County, MN"
2021,Sep,7894,7695,199,2.5,"Roseau County, MN"
2021,Oct,7962,7762,200,2.5,"Roseau County, MN"
2021,Nov,7954,7776,178,2.2,"Roseau County, MN"
2021,Dec,8115,7888,227,2.8,"Roseau County, MN"
2022,Jan,8039,7767,272,3.4,"Roseau County, MN"
2022,Feb,8045,7820,225,2.8,"Roseau County, MN"
2022,Mar,8077,7871,206,2.6,"Roseau County, MN"
2022,Apr,7909,7742,167,2.1,"Roseau County, MN"
2022,May,7955,7781,174,2.2,"Roseau County, MN"
2022,Jun,8112,7911,201,2.5,"Roseau County, MN"
2022,Jul,7899,7710,189,2.4,"Roseau County, MN"
2022,Aug,7844,7647,197,2.5,"Roseau County, MN"
2022,Sep,7823,7681,142,1.8,"Roseau County, MN"
2022,Oct,7904,7754,150,1.9,"Roseau County, MN"
2022,Nov,7792,7624,168,2.2,"Roseau County, MN"
2022,Dec,8025,7793,232,2.9,"Roseau County, MN"
2023,Jan,8049,7785,264,3.3,"Roseau County, MN"
2023,Feb,8103,7849,254,3.1,"Roseau County, MN"
2023,Mar,8114,7890,224,2.8,"Roseau County, MN"
2023,Apr,8040,7851,189,2.4,"Roseau County, MN"
2023,May,8091,7906,185,2.3,"Roseau County, MN"
2023,Jun,8334,8046,288,3.5,"Roseau County, MN"
2023,Jul,8028,7769,259,3.2,"Roseau County, MN"
2023,Aug,8076,7799,277,3.4,"Roseau County, MN"
2023,Sep,8179,8014,165,2.0,"Roseau County, MN"
2023,Oct,8186,8029,157,1.9,"Roseau County, MN"
2023,Nov,8212,8017,195,2.4,"Roseau County, MN"
2023,Dec,8276,7980,296,3.6,"Roseau County, MN"
2024,Jan,8260,7919,341,4.1,"Roseau County, MN"
2024,Feb,8211,7920,291,3.5,"Roseau County, MN"
2024,Mar,8353,8019,334,4.0,"Roseau County, MN"
2024,Apr,8220,7976,244,3.0,"Roseau County, MN"
2024,May,8150,7903,247,3.0,"Roseau County, MN"
2024,Jun,8345,7949,396,4.7,"Roseau County, MN"
2024,Jul,8215,7794,421,5.1,"Roseau County, MN"
2024,Aug,8241,7872,369,4.5,"Roseau County, MN"
2024,Sep,8289,8046,243,2.9,"Roseau County, MN"
2024,Oct,8243,8049,194,2.4,"Roseau County, MN"
2024,Nov,8261(P),8015(P),246(P),3.0(P),"Roseau County, MN"
P : Preliminary.,P : Preliminary.,P : Preliminary.,P : Preliminary.,P : Preliminary.,P : Preliminary.,"Roseau County, MN"
2014,Jan,101821,95071,6750,6.6,"St. Louis County, MN"
2014,Feb,102709,95915,6794,6.6,"St. Louis County, MN"
2014,Mar,102719,96029,6690,6.5,"St. Louis County, MN"
2014,Apr,102012,96283,5729,5.6,"St. Louis County, MN"
2014,May,102379,97050,5329,5.2,"St. Louis County, MN"
2014,Jun,103228,97730,5498,5.3,"St. Louis County, MN"
2014,Jul,103096,97792,5304,5.1,"St. Louis County, MN"
2014,Aug,101770,96938,4832,4.7,"St. Louis County, MN"
2014,Sep,102267,97993,4274,4.2,"St. Louis County, MN"
2014,Oct,102442,98488,3954,3.9,"St. Louis County, MN"
2014,Nov,103554,99195,4359,4.2,"St. Louis County, MN"
2014,Dec,102464,97895,4569,4.5,"St. Louis County, MN"
2015,Jan,100692,95297,5395,5.4,"St. Louis County, MN"
2015,Feb,101787,96388,5399,5.3,"St. Louis County, MN"
2015,Mar,101426,95997,5429,5.4,"St. Louis County, MN"
2015,Apr,102142,97331,4811,4.7,"St. Louis County, MN"
2015,May,102837,98187,4650,4.5,"St. Louis County, MN"
2015,Jun,103232,97690,5542,5.4,"St. Louis County, MN"
2015,Jul,103490,98250,5240,5.1,"St. Louis County, MN"
2015,Aug,101775,97080,4695,4.6,"St. Louis County, MN"
2015,Sep,102350,97658,4692,4.6,"St. Louis County, MN"
2015,Oct,102097,97318,4779,4.7,"St. Louis County, MN"
2015,Nov,102313,96935,5378,5.3,"St. Louis County, MN"
2015,Dec,102396,96090,6306,6.2,"St. Louis County, MN"
2016,Jan,102176,95326,6850,6.7,"St. Louis County, MN"
2016,Feb,103567,96724,6843,6.6,"St. Louis County, MN"
2016,Mar,103551,96245,7306,7.1,"St. Louis County, MN"
2016,Apr,103274,97050,6224,6.0,"St. Louis County, MN"
2016,May,102959,97717,5242,5.1,"St. Louis County, MN"
2016,Jun,102096,96085,6011,5.9,"St. Louis County, MN"
2016,Jul,102750,97055,5695,5.5,"St. Louis County, MN"
2016,Aug,102137,96481,5656,5.5,"St. Louis County, MN"
2016,Sep,102714,97728,4986,4.9,"St. Louis County, MN"
2016,Oct,102416,97505,4911,4.8,"St. Louis County, MN"
2016,Nov,101763,96727,5036,4.9,"St. Louis County, MN"
2016,Dec,101260,95609,5651,5.6,"St. Louis County, MN"
2017,Jan,102016,95561,6455,6.3,"St. Louis County, MN"
2017,Feb,103173,97132,6041,5.9,"St. Louis County, MN"
2017,Mar,103279,97431,5848,5.7,"St. Louis County, MN"
2017,Apr,103631,98497,5134,5.0,"St. Louis County, MN"
2017,May,102950,98407,4543,4.4,"St. Louis County, MN"
2017,Jun,103510,98548,4962,4.8,"St. Louis County, MN"
2017,Jul,103628,99032,4596,4.4,"St. Louis County, MN"
2017,Aug,102577,98027,4550,4.4,"St. Louis County, MN"
2017,Sep,103851,100200,3651,3.5,"St. Louis County, MN"
2017,Oct,102462,99210,3252,3.2,"St. Louis County, MN"
2017,Nov,102791,98713,4078,4.0,"St. Louis County, MN"
2017,Dec,102208,97695,4513,4.4,"St. Louis County, MN"
2018,Jan,101530,96609,4921,4.8,"St. Louis County, MN"
2018,Feb,103432,98517,4915,4.8,"St. Louis County, MN"
2018,Mar,103043,98315,4728,4.6,"St. Louis County, MN"
2018,Apr,102722,98822,3900,3.8,"St. Louis County, MN"
2018,May,102433,98936,3497,3.4,"St. Louis County, MN"
2018,Jun,102325,98330,3995,3.9,"St. Louis County, MN"
2018,Jul,101650,98022,3628,3.6,"St. Louis County, MN"
2018,Aug,100299,96829,3470,3.5,"St. Louis County, MN"
2018,Sep,101565,98640,2925,2.9,"St. Louis County, MN"
2018,Oct,101884,98951,2933,2.9,"St. Louis County, MN"
2018,Nov,101913,98529,3384,3.3,"St. Louis County, MN"
2018,Dec,101807,97487,4320,4.2,"St. Louis County, MN"
2019,Jan,101867,96709,5158,5.1,"St. Louis County, MN"
2019,Feb,103066,98352,4714,4.6,"St. Louis County, MN"
2019,Mar,102790,98032,4758,4.6,"St. Louis County, MN"
2019,Apr,102654,98647,4007,3.9,"St. Louis County, MN"
2019,May,102440,98621,3819,3.7,"St. Louis County, MN"
2019,Jun,102374,98051,4323,4.2,"St. Louis County, MN"
2019,Jul,101778,97612,4166,4.1,"St. Louis County, MN"
2019,Aug,100909,96986,3923,3.9,"St. Louis County, MN"
2019,Sep,101949,98731,3218,3.2,"St. Louis County, MN"
2019,Oct,102616,99248,3368,3.3,"St. Louis County, MN"
2019,Nov,102819,98934,3885,3.8,"St. Louis County, MN"
2019,Dec,102477,98082,4395,4.3,"St. Louis County, MN"
2020,Jan,102459,97604,4855,4.7,"St. Louis County, MN"
2020,Feb,103758,99001,4757,4.6,"St. Louis County, MN"
2020,Mar,103504,97457,6047,5.8,"St. Louis County, MN"
2020,Apr,98810,88489,10321,10.4,"St. Louis County, MN"
2020,May,98984,85659,13325,13.5,"St. Louis County, MN"
2020,Jun,102043,91196,10847,10.6,"St. Louis County, MN"
2020,Jul,102226,92887,9339,9.1,"St. Louis County, MN"
2020,Aug,101998,95065,6933,6.8,"St. Louis County, MN"
2020,Sep,102708,96584,6124,6.0,"St. Louis County, MN"
2020,Oct,102418,97082,5336,5.2,"St. Louis County, MN"
2020,Nov,101292,96375,4917,4.9,"St. Louis County, MN"
2020,Dec,99180,93268,5912,6.0,"St. Louis County, MN"
2021,Jan,98978,93298,5680,5.7,"St. Louis County, MN"
2021,Feb,99662,94316,5346,5.4,"St. Louis County, MN"
2021,Mar,99742,94737,5005,5.0,"St. Louis County, MN"
2021,Apr,99961,95375,4586,4.6,"St. Louis County, MN"
2021,May,99384,95454,3930,4.0,"St. Louis County, MN"
2021,Jun,99129,94497,4632,4.7,"St. Louis County, MN"
2021,Jul,98967,95036,3931,4.0,"St. Louis County, MN"
2021,Aug,98217,94414,3803,3.9,"St. Louis County, MN"
2021,Sep,99566,96347,3219,3.2,"St. Louis County, MN"
2021,Oct,99943,97060,2883,2.9,"St. Louis County, MN"
2021,Nov,100530,97653,2877,2.9,"St. Louis County, MN"
2021,Dec,99672,96285,3387,3.4,"St. Louis County, MN"
2022,Jan,99312,95365,3947,4.0,"St. Louis County, MN"
2022,Feb,99935,96349,3586,3.6,"St. Louis County, MN"
2022,Mar,100377,96957,3420,3.4,"St. Louis County, MN"
2022,Apr,99872,97237,2635,2.6,"St. Louis County, MN"
2022,May,100134,97281,2853,2.8,"St. Louis County, MN"
2022,Jun,100042,96700,3342,3.3,"St. Louis County, MN"
2022,Jul,99865,96797,3068,3.1,"St. Louis County, MN"
2022,Aug,99790,96556,3234,3.2,"St. Louis County, MN"
2022,Sep,101159,98634,2525,2.5,"St. Louis County, MN"
2022,Oct,100275,97771,2504,2.5,"St. Louis County, MN"
2022,Nov,100063,97227,2836,2.8,"St. Louis County, MN"
2022,Dec,99949,96427,3522,3.5,"St. Louis County, MN"
2023,Jan,99439,95590,3849,3.9,"St. Louis County, MN"
2023,Feb,101200,97197,4003,4.0,"St. Louis County, MN"
2023,Mar,101388,97576,3812,3.8,"St. Louis County, MN"
2023,Apr,100782,97456,3326,3.3,"St. Louis County, MN"
2023,May,100977,97793,3184,3.2,"St. Louis County, MN"
2023,Jun,101763,97901,3862,3.8,"St. Louis County, MN"
2023,Jul,101102,97720,3382,3.3,"St. Louis County, MN"
2023,Aug,99761,96370,3391,3.4,"St. Louis County, MN"
2023,Sep,99514,97168,2346,2.4,"St. Louis County, MN"
2023,Oct,99338,97017,2321,2.3,"St. Louis County, MN"
2023,Nov,99006,96836,2170,2.2,"St. Louis County, MN"
2023,Dec,98875,96015,2860,2.9,"St. Louis County, MN"
2024,Jan,99358,95777,3581,3.6,"St. Louis County, MN"
2024,Feb,100327,96242,4085,4.1,"St. Louis County, MN"
2024,Mar,100463,96826,3637,3.6,"St. Louis County, MN"
2024,Apr,99903,96764,3139,3.1,"St. Louis County, MN"
2024,May,99013,95866,3147,3.2,"St. Louis County, MN"
2024,Jun,98484,94148,4336,4.4,"St. Louis County, MN"
2024,Jul,98700,94419,4281,4.3,"St. Louis County, MN"
2024,Aug,97969,93768,4201,4.3,"St. Louis County, MN"
2024,Sep,97672,94768,2904,3.0,"St. Louis County, MN"
2024,Oct,98268,95636,2632,2.7,"St. Louis County, MN"
2024,Nov,98718(P),95512(P),3206(P),3.2(P),"St. Louis County, MN"
P : Preliminary.,P : Preliminary.,P : Preliminary.,P : Preliminary.,P : Preliminary.,P : Preliminary.,"St. Louis County, MN"
2014,Jan,77548,73897,3651,4.7,"Scott County, MN"
2014,Feb,77682,74056,3626,4.7,"Scott County, MN"
2014,Mar,77909,74351,3558,4.6,"Scott County, MN"
2014,Apr,78050,75157,2893,3.7,"Scott County, MN"
2014,May,78453,75752,2701,3.4,"Scott County, MN"
2014,Jun,79018,76024,2994,3.8,"Scott County, MN"
2014,Jul,79321,76370,2951,3.7,"Scott County, MN"
2014,Aug,78532,75844,2688,3.4,"Scott County, MN"
2014,Sep,78261,75773,2488,3.2,"Scott County, MN"
2014,Oct,78443,76169,2274,2.9,"Scott County, MN"
2014,Nov,78481,76209,2272,2.9,"Scott County, MN"
2014,Dec,78296,75706,2590,3.3,"Scott County, MN"
2015,Jan,78441,75305,3136,4.0,"Scott County, MN"
2015,Feb,78800,75805,2995,3.8,"Scott County, MN"
2015,Mar,78581,75653,2928,3.7,"Scott County, MN"
2015,Apr,79188,76828,2360,3.0,"Scott County, MN"
2015,May,79949,77591,2358,2.9,"Scott County, MN"
2015,Jun,79887,77232,2655,3.3,"Scott County, MN"
2015,Jul,80478,77884,2594,3.2,"Scott County, MN"
2015,Aug,79804,77397,2407,3.0,"Scott County, MN"
2015,Sep,79104,76891,2213,2.8,"Scott County, MN"
2015,Oct,79049,76890,2159,2.7,"Scott County, MN"
2015,Nov,79281,77196,2085,2.6,"Scott County, MN"
2015,Dec,79455,76915,2540,3.2,"Scott County, MN"
2016,Jan,79626,76674,2952,3.7,"Scott County, MN"
2016,Feb,80398,77434,2964,3.7,"Scott County, MN"
2016,Mar,80228,77257,2971,3.7,"Scott County, MN"
2016,Apr,80503,78101,2402,3.0,"Scott County, MN"
2016,May,80617,78407,2210,2.7,"Scott County, MN"
2016,Jun,80832,78096,2736,3.4,"Scott County, MN"
2016,Jul,81757,79173,2584,3.2,"Scott County, MN"
2016,Aug,81302,78762,2540,3.1,"Scott County, MN"
2016,Sep,81089,78660,2429,3.0,"Scott County, MN"
2016,Oct,80596,78221,2375,2.9,"Scott County, MN"
2016,Nov,80402,78221,2181,2.7,"Scott County, MN"
2016,Dec,80573,77815,2758,3.4,"Scott County, MN"
2017,Jan,81107,78054,3053,3.8,"Scott County, MN"
2017,Feb,81776,78773,3003,3.7,"Scott County, MN"
2017,Mar,82009,79257,2752,3.4,"Scott County, MN"
2017,Apr,82213,79863,2350,2.9,"Scott County, MN"
2017,May,82342,80049,2293,2.8,"Scott County, MN"
2017,Jun,83212,80541,2671,3.2,"Scott County, MN"
2017,Jul,83755,81315,2440,2.9,"Scott County, MN"
2017,Aug,83203,80806,2397,2.9,"Scott County, MN"
2017,Sep,83232,81177,2055,2.5,"Scott County, MN"
2017,Oct,82270,80439,1831,2.2,"Scott County, MN"
2017,Nov,82478,80643,1835,2.2,"Scott County, MN"
2017,Dec,82477,80157,2320,2.8,"Scott County, MN"
2018,Jan,82706,80133,2573,3.1,"Scott County, MN"
2018,Feb,83444,80825,2619,3.1,"Scott County, MN"
2018,Mar,83049,80460,2589,3.1,"Scott County, MN"
2018,Apr,82721,80626,2095,2.5,"Scott County, MN"
2018,May,82914,81102,1812,2.2,"Scott County, MN"
2018,Jun,83631,81356,2275,2.7,"Scott County, MN"
2018,Jul,83942,81931,2011,2.4,"Scott County, MN"
2018,Aug,83388,81374,2014,2.4,"Scott County, MN"
2018,Sep,83128,81299,1829,2.2,"Scott County, MN"
2018,Oct,83178,81390,1788,2.1,"Scott County, MN"
2018,Nov,83370,81647,1723,2.1,"Scott County, MN"
2018,Dec,83620,81232,2388,2.9,"Scott County, MN"
2019,Jan,84031,81235,2796,3.3,"Scott County, MN"
2019,Feb,84332,81706,2626,3.1,"Scott County, MN"
2019,Mar,84158,81454,2704,3.2,"Scott County, MN"
2019,Apr,83872,81764,2108,2.5,"Scott County, MN"
2019,May,84141,81977,2164,2.6,"Scott County, MN"
2019,Jun,85113,82513,2600,3.1,"Scott County, MN"
2019,Jul,85391,82988,2403,2.8,"Scott County, MN"
2019,Aug,85246,82909,2337,2.7,"Scott County, MN"
2019,Sep,85000,82921,2079,2.4,"Scott County, MN"
2019,Oct,84850,82800,2050,2.4,"Scott County, MN"
2019,Nov,85010,82973,2037,2.4,"Scott County, MN"
2019,Dec,85232,82855,2377,2.8,"Scott County, MN"
2020,Jan,85978,83369,2609,3.0,"Scott County, MN"
2020,Feb,86363,83751,2612,3.0,"Scott County, MN"
2020,Mar,85941,82536,3405,4.0,"Scott County, MN"
2020,Apr,82086,74657,7429,9.1,"Scott County, MN"
2020,May,83434,73686,9748,11.7,"Scott County, MN"
2020,Jun,86203,78549,7654,8.9,"Scott County, MN"
2020,Jul,86693,80046,6647,7.7,"Scott County, MN"
2020,Aug,86601,81389,5212,6.0,"Scott County, MN"
2020,Sep,85670,81030,4640,5.4,"Scott County, MN"
2020,Oct,85370,81513,3857,4.5,"Scott County, MN"
2020,Nov,84676,81597,3079,3.6,"Scott County, MN"
2020,Dec,83507,79681,3826,4.6,"Scott County, MN"
2021,Jan,82491,78710,3781,4.6,"Scott County, MN"
2021,Feb,82615,79102,3513,4.3,"Scott County, MN"
2021,Mar,82759,79310,3449,4.2,"Scott County, MN"
2021,Apr,82935,79881,3054,3.7,"Scott County, MN"
2021,May,82889,80161,2728,3.3,"Scott County, MN"
2021,Jun,83232,79968,3264,3.9,"Scott County, MN"
2021,Jul,83529,80840,2689,3.2,"Scott County, MN"
2021,Aug,83024,80382,2642,3.2,"Scott County, MN"
2021,Sep,82602,80286,2316,2.8,"Scott County, MN"
2021,Oct,82797,80840,1957,2.4,"Scott County, MN"
2021,Nov,83316,81592,1724,2.1,"Scott County, MN"
2021,Dec,83281,81337,1944,2.3,"Scott County, MN"
2022,Jan,83397,81001,2396,2.9,"Scott County, MN"
2022,Feb,83476,81414,2062,2.5,"Scott County, MN"
2022,Mar,83701,81665,2036,2.4,"Scott County, MN"
2022,Apr,84015,82545,1470,1.7,"Scott County, MN"
2022,May,84381,82910,1471,1.7,"Scott County, MN"
2022,Jun,84517,82533,1984,2.3,"Scott County, MN"
2022,Jul,84776,82973,1803,2.1,"Scott County, MN"
2022,Aug,84659,82774,1885,2.2,"Scott County, MN"
2022,Sep,84251,82706,1545,1.8,"Scott County, MN"
2022,Oct,83621,82085,1536,1.8,"Scott County, MN"
2022,Nov,83614,82046,1568,1.9,"Scott County, MN"
2022,Dec,83928,81888,2040,2.4,"Scott County, MN"
2023,Jan,83970,81697,2273,2.7,"Scott County, MN"
2023,Feb,84354,81894,2460,2.9,"Scott County, MN"
2023,Mar,84723,82365,2358,2.8,"Scott County, MN"
2023,Apr,84899,82865,2034,2.4,"Scott County, MN"
2023,May,85259,83246,2013,2.4,"Scott County, MN"
2023,Jun,86240,83625,2615,3.0,"Scott County, MN"
2023,Jul,86191,83790,2401,2.8,"Scott County, MN"
2023,Aug,85492,82943,2549,3.0,"Scott County, MN"
2023,Sep,84918,83042,1876,2.2,"Scott County, MN"
2023,Oct,84563,82757,1806,2.1,"Scott County, MN"
2023,Nov,84427,82957,1470,1.7,"Scott County, MN"
2023,Dec,84062,82101,1961,2.3,"Scott County, MN"
2024,Jan,84363,81930,2433,2.9,"Scott County, MN"
2024,Feb,84941,82171,2770,3.3,"Scott County, MN"
2024,Mar,84929,82491,2438,2.9,"Scott County, MN"
2024,Apr,84912,82808,2104,2.5,"Scott County, MN"
2024,May,84583,82503,2080,2.5,"Scott County, MN"
2024,Jun,84591,81496,3095,3.7,"Scott County, MN"
2024,Jul,84688,81658,3030,3.6,"Scott County, MN"
2024,Aug,84210,81071,3139,3.7,"Scott County, MN"
2024,Sep,83751,81515,2236,2.7,"Scott County, MN"
2024,Oct,83919,81880,2039,2.4,"Scott County, MN"
2024,Nov,83788(P),81564(P),2224(P),2.7(P),"Scott County, MN"
P : Preliminary.,P : Preliminary.,P : Preliminary.,P : Preliminary.,P : Preliminary.,P : Preliminary.,"Scott County, MN"
2014,Jan,49126,46046,3080,6.3,"Sherburne County, MN"
2014,Feb,49216,46147,3069,6.2,"Sherburne County, MN"
2014,Mar,49353,46331,3022,6.1,"Sherburne County, MN"
2014,Apr,49193,46814,2379,4.8,"Sherburne County, MN"
2014,May,49236,47188,2048,4.2,"Sherburne County, MN"
2014,Jun,49569,47371,2198,4.4,"Sherburne County, MN"
2014,Jul,49748,47625,2123,4.3,"Sherburne County, MN"
2014,Aug,49280,47301,1979,4.0,"Sherburne County, MN"
2014,Sep,49070,47229,1841,3.8,"Sherburne County, MN"
2014,Oct,49194,47526,1668,3.4,"Sherburne County, MN"
2014,Nov,49419,47533,1886,3.8,"Sherburne County, MN"
2014,Dec,49428,47225,2203,4.5,"Sherburne County, MN"
2015,Jan,49319,46645,2674,5.4,"Sherburne County, MN"
2015,Feb,49512,46920,2592,5.2,"Sherburne County, MN"
2015,Mar,49399,46868,2531,5.1,"Sherburne County, MN"
2015,Apr,49456,47555,1901,3.8,"Sherburne County, MN"
2015,May,49833,48006,1827,3.7,"Sherburne County, MN"
2015,Jun,49895,47839,2056,4.1,"Sherburne County, MN"
2015,Jul,50146,48225,1921,3.8,"Sherburne County, MN"
2015,Aug,49666,47907,1759,3.5,"Sherburne County, MN"
2015,Sep,49236,47591,1645,3.3,"Sherburne County, MN"
2015,Oct,49282,47692,1590,3.2,"Sherburne County, MN"
2015,Nov,49537,47841,1696,3.4,"Sherburne County, MN"
2015,Dec,49815,47648,2167,4.4,"Sherburne County, MN"
2016,Jan,50398,47784,2614,5.2,"Sherburne County, MN"
2016,Feb,50752,48185,2567,5.1,"Sherburne County, MN"
2016,Mar,50734,48114,2620,5.2,"Sherburne County, MN"
2016,Apr,50613,48619,1994,3.9,"Sherburne County, MN"
2016,May,50467,48788,1679,3.3,"Sherburne County, MN"
2016,Jun,50598,48602,1996,3.9,"Sherburne County, MN"
2016,Jul,51126,49262,1864,3.6,"Sherburne County, MN"
2016,Aug,50818,49007,1811,3.6,"Sherburne County, MN"
2016,Sep,50672,48926,1746,3.4,"Sherburne County, MN"
2016,Oct,50478,48745,1733,3.4,"Sherburne County, MN"
2016,Nov,50496,48747,1749,3.5,"Sherburne County, MN"
2016,Dec,50812,48455,2357,4.6,"Sherburne County, MN"
2017,Jan,51218,48438,2780,5.4,"Sherburne County, MN"
2017,Feb,51534,48843,2691,5.2,"Sherburne County, MN"
2017,Mar,51698,49162,2536,4.9,"Sherburne County, MN"
2017,Apr,51490,49551,1939,3.8,"Sherburne County, MN"
2017,May,51303,49644,1659,3.2,"Sherburne County, MN"
2017,Jun,51847,49924,1923,3.7,"Sherburne County, MN"
2017,Jul,52112,50380,1732,3.3,"Sherburne County, MN"
2017,Aug,51754,50042,1712,3.3,"Sherburne County, MN"
2017,Sep,51756,50265,1491,2.9,"Sherburne County, MN"
2017,Oct,51252,49906,1346,2.6,"Sherburne County, MN"
2017,Nov,51522,50007,1515,2.9,"Sherburne County, MN"
2017,Dec,51676,49693,1983,3.8,"Sherburne County, MN"
2018,Jan,52303,49905,2398,4.6,"Sherburne County, MN"
2018,Feb,52640,50345,2295,4.4,"Sherburne County, MN"
2018,Mar,52364,50138,2226,4.3,"Sherburne County, MN"
2018,Apr,51976,50239,1737,3.3,"Sherburne County, MN"
2018,May,51871,50560,1311,2.5,"Sherburne County, MN"
2018,Jun,52277,50688,1589,3.0,"Sherburne County, MN"
2018,Jul,52472,51045,1427,2.7,"Sherburne County, MN"
2018,Aug,52008,50643,1365,2.6,"Sherburne County, MN"
2018,Sep,51869,50627,1242,2.4,"Sherburne County, MN"
2018,Oct,51989,50731,1258,2.4,"Sherburne County, MN"
2018,Nov,52217,50859,1358,2.6,"Sherburne County, MN"
2018,Dec,52694,50595,2099,4.0,"Sherburne County, MN"
2019,Jan,53400,50643,2757,5.2,"Sherburne County, MN"
2019,Feb,53423,50935,2488,4.7,"Sherburne County, MN"
2019,Mar,53259,50790,2469,4.6,"Sherburne County, MN"
2019,Apr,52898,51032,1866,3.5,"Sherburne County, MN"
2019,May,52729,51189,1540,2.9,"Sherburne County, MN"
2019,Jun,53298,51496,1802,3.4,"Sherburne County, MN"
2019,Jul,53457,51790,1667,3.1,"Sherburne County, MN"
2019,Aug,53261,51689,1572,3.0,"Sherburne County, MN"
2019,Sep,53091,51723,1368,2.6,"Sherburne County, MN"
2019,Oct,53117,51710,1407,2.6,"Sherburne County, MN"
2019,Nov,53297,51754,1543,2.9,"Sherburne County, MN"
2019,Dec,53839,51682,2157,4.0,"Sherburne County, MN"
2020,Jan,54794,52200,2594,4.7,"Sherburne County, MN"
2020,Feb,54917,52435,2482,4.5,"Sherburne County, MN"
2020,Mar,54711,51679,3032,5.5,"Sherburne County, MN"
2020,Apr,51450,46852,4598,8.9,"Sherburne County, MN"
2020,May,51847,46238,5609,10.8,"Sherburne County, MN"
2020,Jun,53743,49261,4482,8.3,"Sherburne County, MN"
2020,Jul,54014,50224,3790,7.0,"Sherburne County, MN"
2020,Aug,53891,50984,2907,5.4,"Sherburne County, MN"
2020,Sep,53330,50773,2557,4.8,"Sherburne County, MN"
2020,Oct,53440,51172,2268,4.2,"Sherburne County, MN"
2020,Nov,53458,51169,2289,4.3,"Sherburne County, MN"
2020,Dec,52906,49980,2926,5.5,"Sherburne County, MN"
2021,Jan,52426,49312,3114,5.9,"Sherburne County, MN"
2021,Feb,52438,49533,2905,5.5,"Sherburne County, MN"
2021,Mar,52291,49659,2632,5.0,"Sherburne County, MN"
2021,Apr,52139,50017,2122,4.1,"Sherburne County, MN"
2021,May,52019,50199,1820,3.5,"Sherburne County, MN"
2021,Jun,52203,50082,2121,4.1,"Sherburne County, MN"
2021,Jul,52418,50639,1779,3.4,"Sherburne County, MN"
2021,Aug,52032,50314,1718,3.3,"Sherburne County, MN"
2021,Sep,51704,50242,1462,2.8,"Sherburne County, MN"
2021,Oct,51931,50643,1288,2.5,"Sherburne County, MN"
2021,Nov,52286,51085,1201,2.3,"Sherburne County, MN"
2021,Dec,52628,50987,1641,3.1,"Sherburne County, MN"
2022,Jan,52943,50757,2186,4.1,"Sherburne County, MN"
2022,Feb,52932,51007,1925,3.6,"Sherburne County, MN"
2022,Mar,52984,51166,1818,3.4,"Sherburne County, MN"
2022,Apr,52926,51677,1249,2.4,"Sherburne County, MN"
2022,May,52952,51897,1055,2.0,"Sherburne County, MN"
2022,Jun,53011,51663,1348,2.5,"Sherburne County, MN"
2022,Jul,53211,51975,1236,2.3,"Sherburne County, MN"
2022,Aug,53151,51805,1346,2.5,"Sherburne County, MN"
2022,Sep,52876,51762,1114,2.1,"Sherburne County, MN"
2022,Oct,52514,51419,1095,2.1,"Sherburne County, MN"
2022,Nov,52610,51370,1240,2.4,"Sherburne County, MN"
2022,Dec,53183,51311,1872,3.5,"Sherburne County, MN"
2023,Jan,53407,51163,2244,4.2,"Sherburne County, MN"
2023,Feb,53652,51288,2364,4.4,"Sherburne County, MN"
2023,Mar,53787,51595,2192,4.1,"Sherburne County, MN"
2023,Apr,53607,51858,1749,3.3,"Sherburne County, MN"
2023,May,53541,52113,1428,2.7,"Sherburne County, MN"
2023,Jun,54225,52330,1895,3.5,"Sherburne County, MN"
2023,Jul,54143,52444,1699,3.1,"Sherburne County, MN"
2023,Aug,53768,51963,1805,3.4,"Sherburne County, MN"
2023,Sep,53224,52027,1197,2.2,"Sherburne County, MN"
2023,Oct,53054,51881,1173,2.2,"Sherburne County, MN"
2023,Nov,53038,52000,1038,2.0,"Sherburne County, MN"
2023,Dec,53015,51406,1609,3.0,"Sherburne County, MN"
2024,Jan,53467,51300,2167,4.1,"Sherburne County, MN"
2024,Feb,53765,51441,2324,4.3,"Sherburne County, MN"
2024,Mar,53722,51680,2042,3.8,"Sherburne County, MN"
2024,Apr,53459,51869,1590,3.0,"Sherburne County, MN"
2024,May,53306,51645,1661,3.1,"Sherburne County, MN"
2024,Jun,53313,51096,2217,4.2,"Sherburne County, MN"
2024,Jul,53458,51221,2237,4.2,"Sherburne County, MN"
2024,Aug,53110,50897,2213,4.2,"Sherburne County, MN"
2024,Sep,52651,51170,1481,2.8,"Sherburne County, MN"
2024,Oct,52736,51374,1362,2.6,"Sherburne County, MN"
2024,Nov,52748(P),51171(P),1577(P),3.0(P),"Sherburne County, MN"
P : Preliminary.,P : Preliminary.,P : Preliminary.,P : Preliminary.,P : Preliminary.,P : Preliminary.,"Sherburne County, MN"
2014,Jan,8217,7664,553,6.7,"Sibley County, MN"
2014,Feb,8198,7661,537,6.6,"Sibley County, MN"
2014,Mar,8246,7698,548,6.6,"Sibley County, MN"
2014,Apr,8123,7708,415,5.1,"Sibley County, MN"
2014,May,8114,7773,341,4.2,"Sibley County, MN"
2014,Jun,8222,7853,369,4.5,"Sibley County, MN"
2014,Jul,8426,8080,346,4.1,"Sibley County, MN"
2014,Aug,8382,8056,326,3.9,"Sibley County, MN"
2014,Sep,8223,7936,287,3.5,"Sibley County, MN"
2014,Oct,8428,8161,267,3.2,"Sibley County, MN"
2014,Nov,8387,8094,293,3.5,"Sibley County, MN"
2014,Dec,8483,8065,418,4.9,"Sibley County, MN"
2015,Jan,8564,8080,484,5.7,"Sibley County, MN"
2015,Feb,8412,7945,467,5.6,"Sibley County, MN"
2015,Mar,8602,8134,468,5.4,"Sibley County, MN"
2015,Apr,8419,8069,350,4.2,"Sibley County, MN"
2015,May,8360,8043,317,3.8,"Sibley County, MN"
2015,Jun,8606,8251,355,4.1,"Sibley County, MN"
2015,Jul,8562,8234,328,3.8,"Sibley County, MN"
2015,Aug,8445,8141,304,3.6,"Sibley County, MN"
2015,Sep,8335,8056,279,3.3,"Sibley County, MN"
2015,Oct,8759,8477,282,3.2,"Sibley County, MN"
2015,Nov,8619,8334,285,3.3,"Sibley County, MN"
2015,Dec,8686,8269,417,4.8,"Sibley County, MN"
2016,Jan,8700,8194,506,5.8,"Sibley County, MN"
2016,Feb,8436,7976,460,5.5,"Sibley County, MN"
2016,Mar,8574,8082,492,5.7,"Sibley County, MN"
2016,Apr,8462,8091,371,4.4,"Sibley County, MN"
2016,May,8350,8062,288,3.4,"Sibley County, MN"
2016,Jun,8421,8080,341,4.0,"Sibley County, MN"
2016,Jul,8477,8153,324,3.8,"Sibley County, MN"
2016,Aug,8397,8090,307,3.7,"Sibley County, MN"
2016,Sep,8270,7999,271,3.3,"Sibley County, MN"
2016,Oct,8595,8311,284,3.3,"Sibley County, MN"
2016,Nov,8593,8299,294,3.4,"Sibley County, MN"
2016,Dec,8583,8165,418,4.9,"Sibley County, MN"
2017,Jan,8623,8135,488,5.7,"Sibley County, MN"
2017,Feb,8484,8007,477,5.6,"Sibley County, MN"
2017,Mar,8525,8086,439,5.1,"Sibley County, MN"
2017,Apr,8515,8199,316,3.7,"Sibley County, MN"
2017,May,8423,8174,249,3.0,"Sibley County, MN"
2017,Jun,8424,8147,277,3.3,"Sibley County, MN"
2017,Jul,8439,8192,247,2.9,"Sibley County, MN"
2017,Aug,8257,8023,234,2.8,"Sibley County, MN"
2017,Sep,8235,8023,212,2.6,"Sibley County, MN"
2017,Oct,8528,8339,189,2.2,"Sibley County, MN"
2017,Nov,8453,8244,209,2.5,"Sibley County, MN"
2017,Dec,8508,8171,337,4.0,"Sibley County, MN"
2018,Jan,8492,8089,403,4.7,"Sibley County, MN"
2018,Feb,8554,8159,395,4.6,"Sibley County, MN"
2018,Mar,8520,8141,379,4.4,"Sibley County, MN"
2018,Apr,8483,8198,285,3.4,"Sibley County, MN"
2018,May,8597,8385,212,2.5,"Sibley County, MN"
2018,Jun,8542,8301,241,2.8,"Sibley County, MN"
2018,Jul,8657,8453,204,2.4,"Sibley County, MN"
2018,Aug,8305,8104,201,2.4,"Sibley County, MN"
2018,Sep,8390,8203,187,2.2,"Sibley County, MN"
2018,Oct,8566,8379,187,2.2,"Sibley County, MN"
2018,Nov,8485,8254,231,2.7,"Sibley County, MN"
2018,Dec,8633,8229,404,4.7,"Sibley County, MN"
2019,Jan,8434,7908,526,6.2,"Sibley County, MN"
2019,Feb,8352,7914,438,5.2,"Sibley County, MN"
2019,Mar,8357,7919,438,5.2,"Sibley County, MN"
2019,Apr,8486,8149,337,4.0,"Sibley County, MN"
2019,May,8585,8323,262,3.1,"Sibley County, MN"
2019,Jun,8589,8285,304,3.5,"Sibley County, MN"
2019,Jul,8725,8454,271,3.1,"Sibley County, MN"
2019,Aug,8448,8192,256,3.0,"Sibley County, MN"
2019,Sep,8471,8242,229,2.7,"Sibley County, MN"
2019,Oct,8703,8468,235,2.7,"Sibley County, MN"
2019,Nov,8500,8234,266,3.1,"Sibley County, MN"
2019,Dec,8624,8203,421,4.9,"Sibley County, MN"
2020,Jan,8316,7859,457,5.5,"Sibley County, MN"
2020,Feb,8339,7901,438,5.3,"Sibley County, MN"
2020,Mar,8251,7746,505,6.1,"Sibley County, MN"
2020,Apr,8015,7413,602,7.5,"Sibley County, MN"
2020,May,8049,7355,694,8.6,"Sibley County, MN"
2020,Jun,8407,7829,578,6.9,"Sibley County, MN"
2020,Jul,8660,8130,530,6.1,"Sibley County, MN"
2020,Aug,8414,8010,404,4.8,"Sibley County, MN"
2020,Sep,8292,7924,368,4.4,"Sibley County, MN"
2020,Oct,8640,8308,332,3.8,"Sibley County, MN"
2020,Nov,8444,8083,361,4.3,"Sibley County, MN"
2020,Dec,8319,7911,408,4.9,"Sibley County, MN"
2021,Jan,8065,7592,473,5.9,"Sibley County, MN"
2021,Feb,8034,7557,477,5.9,"Sibley County, MN"
2021,Mar,7888,7454,434,5.5,"Sibley County, MN"
2021,Apr,7863,7534,329,4.2,"Sibley County, MN"
2021,May,7897,7632,265,3.4,"Sibley County, MN"
2021,Jun,7963,7657,306,3.8,"Sibley County, MN"
2021,Jul,8172,7894,278,3.4,"Sibley County, MN"
2021,Aug,8026,7761,265,3.3,"Sibley County, MN"
2021,Sep,7891,7640,251,3.2,"Sibley County, MN"
2021,Oct,8101,7890,211,2.6,"Sibley County, MN"
2021,Nov,7983,7787,196,2.5,"Sibley County, MN"
2021,Dec,8245,7918,327,4.0,"Sibley County, MN"
2022,Jan,8163,7768,395,4.8,"Sibley County, MN"
2022,Feb,8158,7796,362,4.4,"Sibley County, MN"
2022,Mar,8045,7728,317,3.9,"Sibley County, MN"
2022,Apr,7932,7707,225,2.8,"Sibley County, MN"
2022,May,7933,7763,170,2.1,"Sibley County, MN"
2022,Jun,7931,7719,212,2.7,"Sibley County, MN"
2022,Jul,8194,7993,201,2.5,"Sibley County, MN"
2022,Aug,8044,7844,200,2.5,"Sibley County, MN"
2022,Sep,7949,7772,177,2.2,"Sibley County, MN"
2022,Oct,8088,7925,163,2.0,"Sibley County, MN"
2022,Nov,7965,7774,191,2.4,"Sibley County, MN"
2022,Dec,8219,7881,338,4.1,"Sibley County, MN"
2023,Jan,8175,7790,385,4.7,"Sibley County, MN"
2023,Feb,8192,7795,397,4.8,"Sibley County, MN"
2023,Mar,8160,7783,377,4.6,"Sibley County, MN"
2023,Apr,8034,7742,292,3.6,"Sibley County, MN"
2023,May,8025,7799,226,2.8,"Sibley County, MN"
2023,Jun,8023,7740,283,3.5,"Sibley County, MN"
2023,Jul,8120,7868,252,3.1,"Sibley County, MN"
2023,Aug,8294,8032,262,3.2,"Sibley County, MN"
2023,Sep,8198,8014,184,2.2,"Sibley County, MN"
2023,Oct,8297,8125,172,2.1,"Sibley County, MN"
2023,Nov,8261,8099,162,2.0,"Sibley County, MN"
2023,Dec,8121,7842,279,3.4,"Sibley County, MN"
2024,Jan,8129,7778,351,4.3,"Sibley County, MN"
2024,Feb,8146,7753,393,4.8,"Sibley County, MN"
2024,Mar,8275,7919,356,4.3,"Sibley County, MN"
2024,Apr,8244,7966,278,3.4,"Sibley County, MN"
2024,May,8043,7780,263,3.3,"Sibley County, MN"
2024,Jun,8243,7894,349,4.2,"Sibley County, MN"
2024,Jul,8404,8063,341,4.1,"Sibley County, MN"
2024,Aug,8622,8278,344,4.0,"Sibley County, MN"
2024,Sep,8479,8251,228,2.7,"Sibley County, MN"
2024,Oct,8432,8224,208,2.5,"Sibley County, MN"
2024,Nov,8453(P),8180(P),273(P),3.2(P),"Sibley County, MN"
P : Preliminary.,P : Preliminary.,P : Preliminary.,P : Preliminary.,P : Preliminary.,P : Preliminary.,"Sibley County, MN"
2014,Jan,87137,82286,4851,5.6,"Stearns County, MN"
2014,Feb,87786,83003,4783,5.4,"Stearns County, MN"
2014,Mar,87778,82704,5074,5.8,"Stearns County, MN"
2014,Apr,87809,84097,3712,4.2,"Stearns County, MN"
2014,May,87587,84364,3223,3.7,"Stearns County, MN"
2014,Jun,87782,84199,3583,4.1,"Stearns County, MN"
2014,Jul,88533,85088,3445,3.9,"Stearns County, MN"
2014,Aug,87722,84526,3196,3.6,"Stearns County, MN"
2014,Sep,87798,84865,2933,3.3,"Stearns County, MN"
2014,Oct,88523,85797,2726,3.1,"Stearns County, MN"
2014,Nov,88350,85308,3042,3.4,"Stearns County, MN"
2014,Dec,88222,84705,3517,4.0,"Stearns County, MN"
2015,Jan,88031,83693,4338,4.9,"Stearns County, MN"
2015,Feb,88312,84065,4247,4.8,"Stearns County, MN"
2015,Mar,88656,84698,3958,4.5,"Stearns County, MN"
2015,Apr,88317,85261,3056,3.5,"Stearns County, MN"
2015,May,88257,85241,3016,3.4,"Stearns County, MN"
2015,Jun,88200,84842,3358,3.8,"Stearns County, MN"
2015,Jul,88321,85192,3129,3.5,"Stearns County, MN"
2015,Aug,87723,84865,2858,3.3,"Stearns County, MN"
2015,Sep,87689,85096,2593,3.0,"Stearns County, MN"
2015,Oct,89075,86470,2605,2.9,"Stearns County, MN"
2015,Nov,88713,86077,2636,3.0,"Stearns County, MN"
2015,Dec,88788,85452,3336,3.8,"Stearns County, MN"
2016,Jan,88438,84392,4046,4.6,"Stearns County, MN"
2016,Feb,88769,84702,4067,4.6,"Stearns County, MN"
2016,Mar,89157,85041,4116,4.6,"Stearns County, MN"
2016,Apr,88874,85823,3051,3.4,"Stearns County, MN"
2016,May,88535,85658,2877,3.2,"Stearns County, MN"
2016,Jun,88144,84750,3394,3.9,"Stearns County, MN"
2016,Jul,88624,85447,3177,3.6,"Stearns County, MN"
2016,Aug,88543,85421,3122,3.5,"Stearns County, MN"
2016,Sep,88742,85744,2998,3.4,"Stearns County, MN"
2016,Oct,90029,87110,2919,3.2,"Stearns County, MN"
2016,Nov,89682,86869,2813,3.1,"Stearns County, MN"
2016,Dec,89135,85538,3597,4.0,"Stearns County, MN"
2017,Jan,90229,85896,4333,4.8,"Stearns County, MN"
2017,Feb,90696,86455,4241,4.7,"Stearns County, MN"
2017,Mar,91246,87356,3890,4.3,"Stearns County, MN"
2017,Apr,91269,88231,3038,3.3,"Stearns County, MN"
2017,May,90676,87897,2779,3.1,"Stearns County, MN"
2017,Jun,90412,87261,3151,3.5,"Stearns County, MN"
2017,Jul,90273,87472,2801,3.1,"Stearns County, MN"
2017,Aug,89686,86900,2786,3.1,"Stearns County, MN"
2017,Sep,90169,87738,2431,2.7,"Stearns County, MN"
2017,Oct,90561,88433,2128,2.3,"Stearns County, MN"
2017,Nov,90451,88004,2447,2.7,"Stearns County, MN"
2017,Dec,89968,86876,3092,3.4,"Stearns County, MN"
2018,Jan,89343,85649,3694,4.1,"Stearns County, MN"
2018,Feb,90535,86954,3581,4.0,"Stearns County, MN"
2018,Mar,90418,86910,3508,3.9,"Stearns County, MN"
2018,Apr,90271,87502,2769,3.1,"Stearns County, MN"
2018,May,90362,88098,2264,2.5,"Stearns County, MN"
2018,Jun,89966,87221,2745,3.1,"Stearns County, MN"
2018,Jul,90088,87739,2349,2.6,"Stearns County, MN"
2018,Aug,88813,86461,2352,2.6,"Stearns County, MN"
2018,Sep,90073,87968,2105,2.3,"Stearns County, MN"
2018,Oct,90733,88702,2031,2.2,"Stearns County, MN"
2018,Nov,90654,88466,2188,2.4,"Stearns County, MN"
2018,Dec,90674,87469,3205,3.5,"Stearns County, MN"
2019,Jan,90492,86563,3929,4.3,"Stearns County, MN"
2019,Feb,91181,87503,3678,4.0,"Stearns County, MN"
2019,Mar,91115,87413,3702,4.1,"Stearns County, MN"
2019,Apr,91304,88445,2859,3.1,"Stearns County, MN"
2019,May,91314,88718,2596,2.8,"Stearns County, MN"
2019,Jun,90681,87675,3006,3.3,"Stearns County, MN"
2019,Jul,91317,88564,2753,3.0,"Stearns County, MN"
2019,Aug,90411,87772,2639,2.9,"Stearns County, MN"
2019,Sep,91475,89132,2343,2.6,"Stearns County, MN"
2019,Oct,91961,89775,2186,2.4,"Stearns County, MN"
2019,Nov,91168,88813,2355,2.6,"Stearns County, MN"
2019,Dec,91260,88067,3193,3.5,"Stearns County, MN"
2020,Jan,91316,87436,3880,4.2,"Stearns County, MN"
2020,Feb,91905,88222,3683,4.0,"Stearns County, MN"
2020,Mar,91440,86897,4543,5.0,"Stearns County, MN"
2020,Apr,89113,82060,7053,7.9,"Stearns County, MN"
2020,May,90029,80784,9245,10.3,"Stearns County, MN"
2020,Jun,92631,85255,7376,8.0,"Stearns County, MN"
2020,Jul,92738,86470,6268,6.8,"Stearns County, MN"
2020,Aug,92469,87600,4869,5.3,"Stearns County, MN"
2020,Sep,92626,88182,4444,4.8,"Stearns County, MN"
2020,Oct,93528,89502,4026,4.3,"Stearns County, MN"
2020,Nov,92192,88330,3862,4.2,"Stearns County, MN"
2020,Dec,90314,85830,4484,5.0,"Stearns County, MN"
2021,Jan,89289,84452,4837,5.4,"Stearns County, MN"
2021,Feb,89711,85178,4533,5.1,"Stearns County, MN"
2021,Mar,89484,85134,4350,4.9,"Stearns County, MN"
2021,Apr,89574,85871,3703,4.1,"Stearns County, MN"
2021,May,89269,85815,3454,3.9,"Stearns County, MN"
2021,Jun,88269,84256,4013,4.5,"Stearns County, MN"
2021,Jul,88909,85412,3497,3.9,"Stearns County, MN"
2021,Aug,87885,84572,3313,3.8,"Stearns County, MN"
2021,Sep,88767,86000,2767,3.1,"Stearns County, MN"
2021,Oct,89073,86653,2420,2.7,"Stearns County, MN"
2021,Nov,88795,86607,2188,2.5,"Stearns County, MN"
2021,Dec,88853,86140,2713,3.1,"Stearns County, MN"
2022,Jan,89045,85729,3316,3.7,"Stearns County, MN"
2022,Feb,89376,86460,2916,3.3,"Stearns County, MN"
2022,Mar,89358,86600,2758,3.1,"Stearns County, MN"
2022,Apr,89230,87251,1979,2.2,"Stearns County, MN"
2022,May,89200,87335,1865,2.1,"Stearns County, MN"
2022,Jun,88130,85792,2338,2.7,"Stearns County, MN"
2022,Jul,89187,87083,2104,2.4,"Stearns County, MN"
2022,Aug,88878,86702,2176,2.4,"Stearns County, MN"
2022,Sep,89727,87986,1741,1.9,"Stearns County, MN"
2022,Oct,90136,88371,1765,2.0,"Stearns County, MN"
2022,Nov,89032,87011,2021,2.3,"Stearns County, MN"
2022,Dec,90154,87376,2778,3.1,"Stearns County, MN"
2023,Jan,89666,86537,3129,3.5,"Stearns County, MN"
2023,Feb,90277,87071,3206,3.6,"Stearns County, MN"
2023,Mar,90714,87712,3002,3.3,"Stearns County, MN"
2023,Apr,90341,87853,2488,2.8,"Stearns County, MN"
2023,May,90203,88020,2183,2.4,"Stearns County, MN"
2023,Jun,89896,86928,2968,3.3,"Stearns County, MN"
2023,Jul,90084,87299,2785,3.1,"Stearns County, MN"
2023,Aug,90419,87549,2870,3.2,"Stearns County, MN"
2023,Sep,90474,88633,1841,2.0,"Stearns County, MN"
2023,Oct,90663,88862,1801,2.0,"Stearns County, MN"
2023,Nov,90349,88720,1629,1.8,"Stearns County, MN"
2023,Dec,89791,87492,2299,2.6,"Stearns County, MN"
2024,Jan,90269,87277,2992,3.3,"Stearns County, MN"
2024,Feb,90511,87273,3238,3.6,"Stearns County, MN"
2024,Mar,91031,88219,2812,3.1,"Stearns County, MN"
2024,Apr,90686,88403,2283,2.5,"Stearns County, MN"
2024,May,89780,87383,2397,2.7,"Stearns County, MN"
2024,Jun,90286,86848,3438,3.8,"Stearns County, MN"
2024,Jul,91325,87837,3488,3.8,"Stearns County, MN"
2024,Aug,91641,88200,3441,3.8,"Stearns County, MN"
2024,Sep,91517,89240,2277,2.5,"Stearns County, MN"
2024,Oct,91723,89472,2251,2.5,"Stearns County, MN"
2024,Nov,91560(P),88930(P),2630(P),2.9(P),"Stearns County, MN"
P : Preliminary.,P : Preliminary.,P : Preliminary.,P : Preliminary.,P : Preliminary.,P : Preliminary.,"Stearns County, MN"
2014,Jan,20652,19609,1043,5.1,"Steele County, MN"
2014,Feb,20612,19569,1043,5.1,"Steele County, MN"
2014,Mar,20764,19719,1045,5.0,"Steele County, MN"
2014,Apr,20831,19938,893,4.3,"Steele County, MN"
2014,May,20954,20186,768,3.7,"Steele County, MN"
2014,Jun,21246,20389,857,4.0,"Steele County, MN"
2014,Jul,21124,20296,828,3.9,"Steele County, MN"
2014,Aug,21662,20899,763,3.5,"Steele County, MN"
2014,Sep,21421,20749,672,3.1,"Steele County, MN"
2014,Oct,22526,21917,609,2.7,"Steele County, MN"
2014,Nov,22269,21634,635,2.9,"Steele County, MN"
2014,Dec,22129,21371,758,3.4,"Steele County, MN"
2015,Jan,20913,20011,902,4.3,"Steele County, MN"
2015,Feb,20886,19987,899,4.3,"Steele County, MN"
2015,Mar,20944,20093,851,4.1,"Steele County, MN"
2015,Apr,20883,20212,671,3.2,"Steele County, MN"
2015,May,21314,20639,675,3.2,"Steele County, MN"
2015,Jun,21229,20461,768,3.6,"Steele County, MN"
2015,Jul,21202,20451,751,3.5,"Steele County, MN"
2015,Aug,21658,20959,699,3.2,"Steele County, MN"
2015,Sep,21036,20421,615,2.9,"Steele County, MN"
2015,Oct,22038,21458,580,2.6,"Steele County, MN"
2015,Nov,21906,21330,576,2.6,"Steele County, MN"
2015,Dec,20991,20284,707,3.4,"Steele County, MN"
2016,Jan,21132,20272,860,4.1,"Steele County, MN"
2016,Feb,20985,20116,869,4.1,"Steele County, MN"
2016,Mar,21077,20198,879,4.2,"Steele County, MN"
2016,Apr,20967,20297,670,3.2,"Steele County, MN"
2016,May,21005,20399,606,2.9,"Steele County, MN"
2016,Jun,21022,20217,805,3.8,"Steele County, MN"
2016,Jul,20888,20103,785,3.8,"Steele County, MN"
2016,Aug,20976,20196,780,3.7,"Steele County, MN"
2016,Sep,21223,20552,671,3.2,"Steele County, MN"
2016,Oct,21726,21062,664,3.1,"Steele County, MN"
2016,Nov,21490,20845,645,3.0,"Steele County, MN"
2016,Dec,21619,20807,812,3.8,"Steele County, MN"
2017,Jan,20628,19680,948,4.6,"Steele County, MN"
2017,Feb,20471,19599,872,4.3,"Steele County, MN"
2017,Mar,20646,19833,813,3.9,"Steele County, MN"
2017,Apr,20639,19954,685,3.3,"Steele County, MN"
2017,May,20642,20008,634,3.1,"Steele County, MN"
2017,Jun,20960,20180,780,3.7,"Steele County, MN"
2017,Jul,20655,19926,729,3.5,"Steele County, MN"
2017,Aug,20583,19855,728,3.5,"Steele County, MN"
2017,Sep,20542,19986,556,2.7,"Steele County, MN"
2017,Oct,20543,20050,493,2.4,"Steele County, MN"
2017,Nov,20548,20038,510,2.5,"Steele County, MN"
2017,Dec,20672,19994,678,3.3,"Steele County, MN"
2018,Jan,20424,19599,825,4.0,"Steele County, MN"
2018,Feb,20452,19650,802,3.9,"Steele County, MN"
2018,Mar,20477,19674,803,3.9,"Steele County, MN"
2018,Apr,20463,19818,645,3.2,"Steele County, MN"
2018,May,20389,19857,532,2.6,"Steele County, MN"
2018,Jun,20774,20122,652,3.1,"Steele County, MN"
2018,Jul,20526,19911,615,3.0,"Steele County, MN"
2018,Aug,20422,19845,577,2.8,"Steele County, MN"
2018,Sep,20410,19938,472,2.3,"Steele County, MN"
2018,Oct,20462,20009,453,2.2,"Steele County, MN"
2018,Nov,20476,20040,436,2.1,"Steele County, MN"
2018,Dec,20595,19908,687,3.3,"Steele County, MN"
2019,Jan,20974,20114,860,4.1,"Steele County, MN"
2019,Feb,20838,20060,778,3.7,"Steele County, MN"
2019,Mar,20854,20047,807,3.9,"Steele County, MN"
2019,Apr,20899,20273,626,3.0,"Steele County, MN"
2019,May,21020,20421,599,2.8,"Steele County, MN"
2019,Jun,21487,20748,739,3.4,"Steele County, MN"
2019,Jul,21375,20634,741,3.5,"Steele County, MN"
2019,Aug,21229,20556,673,3.2,"Steele County, MN"
2019,Sep,21429,20873,556,2.6,"Steele County, MN"
2019,Oct,22005,21463,542,2.5,"Steele County, MN"
2019,Nov,21886,21346,540,2.5,"Steele County, MN"
2019,Dec,21155,20446,709,3.4,"Steele County, MN"
2020,Jan,20489,19656,833,4.1,"Steele County, MN"
2020,Feb,20468,19687,781,3.8,"Steele County, MN"
2020,Mar,20428,19418,1010,4.9,"Steele County, MN"
2020,Apr,19527,18075,1452,7.4,"Steele County, MN"
2020,May,19923,18000,1923,9.7,"Steele County, MN"
2020,Jun,20643,19059,1584,7.7,"Steele County, MN"
2020,Jul,20780,19337,1443,6.9,"Steele County, MN"
2020,Aug,20735,19655,1080,5.2,"Steele County, MN"
2020,Sep,20693,19717,976,4.7,"Steele County, MN"
2020,Oct,21788,20903,885,4.1,"Steele County, MN"
2020,Nov,21696,20919,777,3.6,"Steele County, MN"
2020,Dec,20672,19759,913,4.4,"Steele County, MN"
2021,Jan,20728,19763,965,4.7,"Steele County, MN"
2021,Feb,20628,19700,928,4.5,"Steele County, MN"
2021,Mar,20668,19703,965,4.7,"Steele County, MN"
2021,Apr,20495,19690,805,3.9,"Steele County, MN"
2021,May,20607,19936,671,3.3,"Steele County, MN"
2021,Jun,20726,19889,837,4.0,"Steele County, MN"
2021,Jul,20431,19735,696,3.4,"Steele County, MN"
2021,Aug,20371,19693,678,3.3,"Steele County, MN"
2021,Sep,19843,19276,567,2.9,"Steele County, MN"
2021,Oct,20151,19677,474,2.4,"Steele County, MN"
2021,Nov,19986,19547,439,2.2,"Steele County, MN"
2021,Dec,20130,19559,571,2.8,"Steele County, MN"
2022,Jan,19203,18482,721,3.8,"Steele County, MN"
2022,Feb,18955,18351,604,3.2,"Steele County, MN"
2022,Mar,19136,18531,605,3.2,"Steele County, MN"
2022,Apr,19179,18746,433,2.3,"Steele County, MN"
2022,May,19220,18827,393,2.0,"Steele County, MN"
2022,Jun,19303,18767,536,2.8,"Steele County, MN"
2022,Jul,19333,18824,509,2.6,"Steele County, MN"
2022,Aug,19285,18719,566,2.9,"Steele County, MN"
2022,Sep,19239,18819,420,2.2,"Steele County, MN"
2022,Oct,19132,18724,408,2.1,"Steele County, MN"
2022,Nov,18954,18508,446,2.4,"Steele County, MN"
2022,Dec,19158,18556,602,3.1,"Steele County, MN"
2023,Jan,19015,18348,667,3.5,"Steele County, MN"
2023,Feb,19138,18431,707,3.7,"Steele County, MN"
2023,Mar,19112,18442,670,3.5,"Steele County, MN"
2023,Apr,18990,18438,552,2.9,"Steele County, MN"
2023,May,19012,18494,518,2.7,"Steele County, MN"
2023,Jun,19332,18639,693,3.6,"Steele County, MN"
2023,Jul,18918,18305,613,3.2,"Steele County, MN"
2023,Aug,19040,18386,654,3.4,"Steele County, MN"
2023,Sep,19041,18585,456,2.4,"Steele County, MN"
2023,Oct,19081,18628,453,2.4,"Steele County, MN"
2023,Nov,18907,18552,355,1.9,"Steele County, MN"
2023,Dec,18821,18324,497,2.6,"Steele County, MN"
2024,Jan,18005,17349,656,3.6,"Steele County, MN"
2024,Feb,18008,17294,714,4.0,"Steele County, MN"
2024,Mar,18036,17437,599,3.3,"Steele County, MN"
2024,Apr,18043,17532,511,2.8,"Steele County, MN"
2024,May,17878,17354,524,2.9,"Steele County, MN"
2024,Jun,18163,17416,747,4.1,"Steele County, MN"
2024,Jul,18018,17288,730,4.1,"Steele County, MN"
2024,Aug,18254,17451,803,4.4,"Steele County, MN"
2024,Sep,18179,17645,534,2.9,"Steele County, MN"
2024,Oct,18062,17612,450,2.5,"Steele County, MN"
2024,Nov,18055(P),17517(P),538(P),3.0(P),"Steele County, MN"
P : Preliminary.,P : Preliminary.,P : Preliminary.,P : Preliminary.,P : Preliminary.,P : Preliminary.,"Steele County, MN"
2014,Jan,5376,5113,263,4.9,"Stevens County, MN"
2014,Feb,5444,5189,255,4.7,"Stevens County, MN"
2014,Mar,5491,5253,238,4.3,"Stevens County, MN"
2014,Apr,5447,5270,177,3.2,"Stevens County, MN"
2014,May,5483,5325,158,2.9,"Stevens County, MN"
2014,Jun,5634,5449,185,3.3,"Stevens County, MN"
2014,Jul,5711,5533,178,3.1,"Stevens County, MN"
2014,Aug,5711,5558,153,2.7,"Stevens County, MN"
2014,Sep,5530,5385,145,2.6,"Stevens County, MN"
2014,Oct,5738,5598,140,2.4,"Stevens County, MN"
2014,Nov,5664,5526,138,2.4,"Stevens County, MN"
2014,Dec,5734,5541,193,3.4,"Stevens County, MN"
2015,Jan,5657,5411,246,4.3,"Stevens County, MN"
2015,Feb,5558,5339,219,3.9,"Stevens County, MN"
2015,Mar,5647,5446,201,3.6,"Stevens County, MN"
2015,Apr,5648,5509,139,2.5,"Stevens County, MN"
2015,May,5592,5447,145,2.6,"Stevens County, MN"
2015,Jun,5779,5606,173,3.0,"Stevens County, MN"
2015,Jul,5778,5619,159,2.8,"Stevens County, MN"
2015,Aug,5677,5547,130,2.3,"Stevens County, MN"
2015,Sep,5654,5524,130,2.3,"Stevens County, MN"
2015,Oct,5962,5838,124,2.1,"Stevens County, MN"
2015,Nov,5842,5718,124,2.1,"Stevens County, MN"
2015,Dec,5860,5681,179,3.1,"Stevens County, MN"
2016,Jan,5774,5556,218,3.8,"Stevens County, MN"
2016,Feb,5631,5432,199,3.5,"Stevens County, MN"
2016,Mar,5706,5513,193,3.4,"Stevens County, MN"
2016,Apr,5630,5483,147,2.6,"Stevens County, MN"
2016,May,5535,5396,139,2.5,"Stevens County, MN"
2016,Jun,5672,5486,186,3.3,"Stevens County, MN"
2016,Jul,5645,5492,153,2.7,"Stevens County, MN"
2016,Aug,5544,5393,151,2.7,"Stevens County, MN"
2016,Sep,5511,5366,145,2.6,"Stevens County, MN"
2016,Oct,5755,5604,151,2.6,"Stevens County, MN"
2016,Nov,5694,5553,141,2.5,"Stevens County, MN"
2016,Dec,5671,5463,208,3.7,"Stevens County, MN"
2017,Jan,5589,5364,225,4.0,"Stevens County, MN"
2017,Feb,5538,5330,208,3.8,"Stevens County, MN"
2017,Mar,5579,5391,188,3.4,"Stevens County, MN"
2017,Apr,5578,5449,129,2.3,"Stevens County, MN"
2017,May,5461,5331,130,2.4,"Stevens County, MN"
2017,Jun,5522,5370,152,2.8,"Stevens County, MN"
2017,Jul,5492,5358,134,2.4,"Stevens County, MN"
2017,Aug,5379,5242,137,2.5,"Stevens County, MN"
2017,Sep,5455,5333,122,2.2,"Stevens County, MN"
2017,Oct,5667,5573,94,1.7,"Stevens County, MN"
2017,Nov,5579,5480,99,1.8,"Stevens County, MN"
2017,Dec,5539,5380,159,2.9,"Stevens County, MN"
2018,Jan,5266,5091,175,3.3,"Stevens County, MN"
2018,Feb,5334,5157,177,3.3,"Stevens County, MN"
2018,Mar,5395,5223,172,3.2,"Stevens County, MN"
2018,Apr,5394,5270,124,2.3,"Stevens County, MN"
2018,May,5552,5449,103,1.9,"Stevens County, MN"
2018,Jun,5604,5462,142,2.5,"Stevens County, MN"
2018,Jul,5571,5457,114,2.0,"Stevens County, MN"
2018,Aug,5355,5237,118,2.2,"Stevens County, MN"
2018,Sep,5445,5333,112,2.1,"Stevens County, MN"
2018,Oct,5561,5472,89,1.6,"Stevens County, MN"
2018,Nov,5461,5361,100,1.8,"Stevens County, MN"
2018,Dec,5454,5286,168,3.1,"Stevens County, MN"
2019,Jan,5227,5024,203,3.9,"Stevens County, MN"
2019,Feb,5298,5118,180,3.4,"Stevens County, MN"
2019,Mar,5353,5167,186,3.5,"Stevens County, MN"
2019,Apr,5516,5377,139,2.5,"Stevens County, MN"
2019,May,5701,5578,123,2.2,"Stevens County, MN"
2019,Jun,5610,5452,158,2.8,"Stevens County, MN"
2019,Jul,5589,5446,143,2.6,"Stevens County, MN"
2019,Aug,5415,5280,135,2.5,"Stevens County, MN"
2019,Sep,5449,5334,115,2.1,"Stevens County, MN"
2019,Oct,5629,5526,103,1.8,"Stevens County, MN"
2019,Nov,5443,5322,121,2.2,"Stevens County, MN"
2019,Dec,5450,5273,177,3.2,"Stevens County, MN"
2020,Jan,5181,4990,191,3.7,"Stevens County, MN"
2020,Feb,5274,5098,176,3.3,"Stevens County, MN"
2020,Mar,5258,5023,235,4.5,"Stevens County, MN"
2020,Apr,5242,5052,190,3.6,"Stevens County, MN"
2020,May,5367,5167,200,3.7,"Stevens County, MN"
2020,Jun,5626,5419,207,3.7,"Stevens County, MN"
2020,Jul,5670,5490,180,3.2,"Stevens County, MN"
2020,Aug,5584,5431,153,2.7,"Stevens County, MN"
2020,Sep,5529,5398,131,2.4,"Stevens County, MN"
2020,Oct,5751,5620,131,2.3,"Stevens County, MN"
2020,Nov,5544,5388,156,2.8,"Stevens County, MN"
2020,Dec,5544,5347,197,3.6,"Stevens County, MN"
2021,Jan,5178,4968,210,4.1,"Stevens County, MN"
2021,Feb,5212,5009,203,3.9,"Stevens County, MN"
2021,Mar,5204,5005,199,3.8,"Stevens County, MN"
2021,Apr,5244,5110,134,2.6,"Stevens County, MN"
2021,May,5289,5185,104,2.0,"Stevens County, MN"
2021,Jun,5394,5252,142,2.6,"Stevens County, MN"
2021,Jul,5408,5301,107,2.0,"Stevens County, MN"
2021,Aug,5341,5225,116,2.2,"Stevens County, MN"
2021,Sep,5300,5209,91,1.7,"Stevens County, MN"
2021,Oct,5454,5375,79,1.4,"Stevens County, MN"
2021,Nov,5364,5275,89,1.7,"Stevens County, MN"
2021,Dec,5572,5427,145,2.6,"Stevens County, MN"
2022,Jan,5319,5146,173,3.3,"Stevens County, MN"
2022,Feb,5340,5189,151,2.8,"Stevens County, MN"
2022,Mar,5351,5212,139,2.6,"Stevens County, MN"
2022,Apr,5283,5190,93,1.8,"Stevens County, MN"
2022,May,5348,5257,91,1.7,"Stevens County, MN"
2022,Jun,5376,5266,110,2.0,"Stevens County, MN"
2022,Jul,5413,5318,95,1.8,"Stevens County, MN"
2022,Aug,5295,5195,100,1.9,"Stevens County, MN"
2022,Sep,5320,5248,72,1.4,"Stevens County, MN"
2022,Oct,5336,5267,69,1.3,"Stevens County, MN"
2022,Nov,5272,5173,99,1.9,"Stevens County, MN"
2022,Dec,5491,5334,157,2.9,"Stevens County, MN"
2023,Jan,5265,5098,167,3.2,"Stevens County, MN"
2023,Feb,5383,5220,163,3.0,"Stevens County, MN"
2023,Mar,5366,5214,152,2.8,"Stevens County, MN"
2023,Apr,5349,5215,134,2.5,"Stevens County, MN"
2023,May,5427,5320,107,2.0,"Stevens County, MN"
2023,Jun,5360,5228,132,2.5,"Stevens County, MN"
2023,Jul,5326,5197,129,2.4,"Stevens County, MN"
2023,Aug,5465,5334,131,2.4,"Stevens County, MN"
2023,Sep,5605,5519,86,1.5,"Stevens County, MN"
2023,Oct,5636,5545,91,1.6,"Stevens County, MN"
2023,Nov,5593,5495,98,1.8,"Stevens County, MN"
2023,Dec,5538,5388,150,2.7,"Stevens County, MN"
2024,Jan,5351,5183,168,3.1,"Stevens County, MN"
2024,Feb,5415,5231,184,3.4,"Stevens County, MN"
2024,Mar,5523,5363,160,2.9,"Stevens County, MN"
2024,Apr,5551,5425,126,2.3,"Stevens County, MN"
2024,May,5485,5350,135,2.5,"Stevens County, MN"
2024,Jun,5602,5428,174,3.1,"Stevens County, MN"
2024,Jul,5630,5460,170,3.0,"Stevens County, MN"
2024,Aug,5771,5610,161,2.8,"Stevens County, MN"
2024,Sep,5762,5663,99,1.7,"Stevens County, MN"
2024,Oct,5759,5640,119,2.1,"Stevens County, MN"
2024,Nov,5716(P),5594(P),122(P),2.1(P),"Stevens County, MN"
P : Preliminary.,P : Preliminary.,P : Preliminary.,P : Preliminary.,P : Preliminary.,P : Preliminary.,"Stevens County, MN"
2014,Jan,4803,4452,351,7.3,"Swift County, MN"
2014,Feb,4802,4463,339,7.1,"Swift County, MN"
2014,Mar,4804,4468,336,7.0,"Swift County, MN"
2014,Apr,4762,4514,248,5.2,"Swift County, MN"
2014,May,4792,4588,204,4.3,"Swift County, MN"
2014,Jun,4939,4718,221,4.5,"Swift County, MN"
2014,Jul,4999,4780,219,4.4,"Swift County, MN"
2014,Aug,4970,4766,204,4.1,"Swift County, MN"
2014,Sep,4849,4683,166,3.4,"Swift County, MN"
2014,Oct,4932,4783,149,3.0,"Swift County, MN"
2014,Nov,4923,4731,192,3.9,"Swift County, MN"
2014,Dec,4980,4712,268,5.4,"Swift County, MN"
2015,Jan,5221,4798,423,8.1,"Swift County, MN"
2015,Feb,5002,4692,310,6.2,"Swift County, MN"
2015,Mar,5177,4849,328,6.3,"Swift County, MN"
2015,Apr,5041,4791,250,5.0,"Swift County, MN"
2015,May,5107,4750,357,7.0,"Swift County, MN"
2015,Jun,5397,4965,432,8.0,"Swift County, MN"
2015,Jul,5274,4899,375,7.1,"Swift County, MN"
2015,Aug,5054,4832,222,4.4,"Swift County, MN"
2015,Sep,4960,4778,182,3.7,"Swift County, MN"
2015,Oct,5492,5118,374,6.8,"Swift County, MN"
2015,Nov,5245,4998,247,4.7,"Swift County, MN"
2015,Dec,5261,4937,324,6.2,"Swift County, MN"
2016,Jan,5304,4821,483,9.1,"Swift County, MN"
2016,Feb,5009,4666,343,6.8,"Swift County, MN"
2016,Mar,5095,4733,362,7.1,"Swift County, MN"
2016,Apr,4996,4731,265,5.3,"Swift County, MN"
2016,May,4925,4719,206,4.2,"Swift County, MN"
2016,Jun,5074,4832,242,4.8,"Swift County, MN"
2016,Jul,5032,4796,236,4.7,"Swift County, MN"
2016,Aug,4983,4747,236,4.7,"Swift County, MN"
2016,Sep,4885,4680,205,4.2,"Swift County, MN"
2016,Oct,5047,4853,194,3.8,"Swift County, MN"
2016,Nov,5106,4900,206,4.0,"Swift County, MN"
2016,Dec,5084,4794,290,5.7,"Swift County, MN"
2017,Jan,5185,4849,336,6.5,"Swift County, MN"
2017,Feb,5045,4751,294,5.8,"Swift County, MN"
2017,Mar,5092,4804,288,5.7,"Swift County, MN"
2017,Apr,5118,4886,232,4.5,"Swift County, MN"
2017,May,5070,4906,164,3.2,"Swift County, MN"
2017,Jun,5155,4966,189,3.7,"Swift County, MN"
2017,Jul,5062,4882,180,3.6,"Swift County, MN"
2017,Aug,4949,4765,184,3.7,"Swift County, MN"
2017,Sep,4882,4748,134,2.7,"Swift County, MN"
2017,Oct,5095,4980,115,2.3,"Swift County, MN"
2017,Nov,5070,4917,153,3.0,"Swift County, MN"
2017,Dec,5140,4890,250,4.9,"Swift County, MN"
2018,Jan,4994,4705,289,5.8,"Swift County, MN"
2018,Feb,5001,4734,267,5.3,"Swift County, MN"
2018,Mar,4998,4735,263,5.3,"Swift County, MN"
2018,Apr,5017,4800,217,4.3,"Swift County, MN"
2018,May,5078,4943,135,2.7,"Swift County, MN"
2018,Jun,5178,4995,183,3.5,"Swift County, MN"
2018,Jul,5140,4974,166,3.2,"Swift County, MN"
2018,Aug,4904,4760,144,2.9,"Swift County, MN"
2018,Sep,4898,4773,125,2.6,"Swift County, MN"
2018,Oct,5015,4904,111,2.2,"Swift County, MN"
2018,Nov,4953,4831,122,2.5,"Swift County, MN"
2018,Dec,5076,4840,236,4.6,"Swift County, MN"
2019,Jan,4770,4474,296,6.2,"Swift County, MN"
2019,Feb,4744,4495,249,5.2,"Swift County, MN"
2019,Mar,4776,4533,243,5.1,"Swift County, MN"
2019,Apr,4879,4671,208,4.3,"Swift County, MN"
2019,May,4967,4821,146,2.9,"Swift County, MN"
2019,Jun,5036,4862,174,3.5,"Swift County, MN"
2019,Jul,5146,4897,249,4.8,"Swift County, MN"
2019,Aug,4926,4764,162,3.3,"Swift County, MN"
2019,Sep,4906,4739,167,3.4,"Swift County, MN"
2019,Oct,5001,4845,156,3.1,"Swift County, MN"
2019,Nov,4960,4707,253,5.1,"Swift County, MN"
2019,Dec,4988,4682,306,6.1,"Swift County, MN"
2020,Jan,4733,4416,317,6.7,"Swift County, MN"
2020,Feb,4735,4460,275,5.8,"Swift County, MN"
2020,Mar,4691,4371,320,6.8,"Swift County, MN"
2020,Apr,4793,4398,395,8.2,"Swift County, MN"
2020,May,4704,4396,308,6.5,"Swift County, MN"
2020,Jun,5043,4751,292,5.8,"Swift County, MN"
2020,Jul,5191,4859,332,6.4,"Swift County, MN"
2020,Aug,5092,4783,309,6.1,"Swift County, MN"
2020,Sep,4846,4657,189,3.9,"Swift County, MN"
2020,Oct,5100,4896,204,4.0,"Swift County, MN"
2020,Nov,4968,4741,227,4.6,"Swift County, MN"
2020,Dec,4931,4643,288,5.8,"Swift County, MN"
2021,Jan,4762,4464,298,6.3,"Swift County, MN"
2021,Feb,4738,4466,272,5.7,"Swift County, MN"
2021,Mar,4637,4380,257,5.5,"Swift County, MN"
2021,Apr,4630,4431,199,4.3,"Swift County, MN"
2021,May,4683,4527,156,3.3,"Swift County, MN"
2021,Jun,4831,4637,194,4.0,"Swift County, MN"
2021,Jul,4906,4728,178,3.6,"Swift County, MN"
2021,Aug,4838,4673,165,3.4,"Swift County, MN"
2021,Sep,4736,4605,131,2.8,"Swift County, MN"
2021,Oct,4874,4763,111,2.3,"Swift County, MN"
2021,Nov,4783,4667,116,2.4,"Swift County, MN"
2021,Dec,4921,4741,180,3.7,"Swift County, MN"
2022,Jan,4860,4644,216,4.4,"Swift County, MN"
2022,Feb,4855,4666,189,3.9,"Swift County, MN"
2022,Mar,4798,4628,170,3.5,"Swift County, MN"
2022,Apr,4705,4579,126,2.7,"Swift County, MN"
2022,May,4751,4640,111,2.3,"Swift County, MN"
2022,Jun,4855,4718,137,2.8,"Swift County, MN"
2022,Jul,4926,4793,133,2.7,"Swift County, MN"
2022,Aug,4859,4726,133,2.7,"Swift County, MN"
2022,Sep,4736,4640,96,2.0,"Swift County, MN"
2022,Oct,4885,4791,94,1.9,"Swift County, MN"
2022,Nov,4782,4677,105,2.2,"Swift County, MN"
2022,Dec,4930,4758,172,3.5,"Swift County, MN"
2023,Jan,4894,4699,195,4.0,"Swift County, MN"
2023,Feb,4880,4680,200,4.1,"Swift County, MN"
2023,Mar,4826,4646,180,3.7,"Swift County, MN"
2023,Apr,4823,4666,157,3.3,"Swift County, MN"
2023,May,4821,4686,135,2.8,"Swift County, MN"
2023,Jun,4917,4750,167,3.4,"Swift County, MN"
2023,Jul,4895,4741,154,3.1,"Swift County, MN"
2023,Aug,5053,4889,164,3.2,"Swift County, MN"
2023,Sep,4987,4871,116,2.3,"Swift County, MN"
2023,Oct,5066,4960,106,2.1,"Swift County, MN"
2023,Nov,5052,4938,114,2.3,"Swift County, MN"
2023,Dec,4975,4817,158,3.2,"Swift County, MN"
2024,Jan,4943,4738,205,4.1,"Swift County, MN"
2024,Feb,4919,4712,207,4.2,"Swift County, MN"
2024,Mar,5008,4825,183,3.7,"Swift County, MN"
2024,Apr,5026,4876,150,3.0,"Swift County, MN"
2024,May,4893,4759,134,2.7,"Swift County, MN"
2024,Jun,5109,4903,206,4.0,"Swift County, MN"
2024,Jul,5138,4935,203,4.0,"Swift County, MN"
2024,Aug,5303,5121,182,3.4,"Swift County, MN"
2024,Sep,5198,5074,124,2.4,"Swift County, MN"
2024,Oct,5377,5088,289,5.4,"Swift County, MN"
2024,Nov,5220(P),5078(P),142(P),2.7(P),"Swift County, MN"
P : Preliminary.,P : Preliminary.,P : Preliminary.,P : Preliminary.,P : Preliminary.,P : Preliminary.,"Swift County, MN"
2014,Jan,12891,12005,886,6.9,"Todd County, MN"
2014,Feb,12947,12071,876,6.8,"Todd County, MN"
2014,Mar,12964,12130,834,6.4,"Todd County, MN"
2014,Apr,12807,12142,665,5.2,"Todd County, MN"
2014,May,12711,12226,485,3.8,"Todd County, MN"
2014,Jun,12847,12310,537,4.2,"Todd County, MN"
2014,Jul,12774,12261,513,4.0,"Todd County, MN"
2014,Aug,12786,12298,488,3.8,"Todd County, MN"
2014,Sep,12687,12271,416,3.3,"Todd County, MN"
2014,Oct,12851,12441,410,3.2,"Todd County, MN"
2014,Nov,12865,12322,543,4.2,"Todd County, MN"
2014,Dec,13032,12356,676,5.2,"Todd County, MN"
2015,Jan,13178,12387,791,6.0,"Todd County, MN"
2015,Feb,13032,12258,774,5.9,"Todd County, MN"
2015,Mar,13292,12539,753,5.7,"Todd County, MN"
2015,Apr,13024,12470,554,4.3,"Todd County, MN"
2015,May,12822,12328,494,3.9,"Todd County, MN"
2015,Jun,13141,12615,526,4.0,"Todd County, MN"
2015,Jul,12771,12282,489,3.8,"Todd County, MN"
2015,Aug,12755,12294,461,3.6,"Todd County, MN"
2015,Sep,12642,12216,426,3.4,"Todd County, MN"
2015,Oct,13251,12812,439,3.3,"Todd County, MN"
2015,Nov,13234,12670,564,4.3,"Todd County, MN"
2015,Dec,13339,12616,723,5.4,"Todd County, MN"
2016,Jan,13344,12516,828,6.2,"Todd County, MN"
2016,Feb,13077,12264,813,6.2,"Todd County, MN"
2016,Mar,13247,12417,830,6.3,"Todd County, MN"
2016,Apr,12921,12313,608,4.7,"Todd County, MN"
2016,May,12699,12250,449,3.5,"Todd County, MN"
2016,Jun,12810,12279,531,4.1,"Todd County, MN"
2016,Jul,12610,12116,494,3.9,"Todd County, MN"
2016,Aug,12588,12106,482,3.8,"Todd County, MN"
2016,Sep,12442,11999,443,3.6,"Todd County, MN"
2016,Oct,12945,12477,468,3.6,"Todd County, MN"
2016,Nov,13042,12443,599,4.6,"Todd County, MN"
2016,Dec,13068,12321,747,5.7,"Todd County, MN"
2017,Jan,13858,12965,893,6.4,"Todd County, MN"
2017,Feb,13692,12892,800,5.8,"Todd County, MN"
2017,Mar,13781,13048,733,5.3,"Todd County, MN"
2017,Apr,13666,13125,541,4.0,"Todd County, MN"
2017,May,13495,13101,394,2.9,"Todd County, MN"
2017,Jun,13445,13015,430,3.2,"Todd County, MN"
2017,Jul,13357,12952,405,3.0,"Todd County, MN"
2017,Aug,13177,12760,417,3.2,"Todd County, MN"
2017,Sep,13195,12857,338,2.6,"Todd County, MN"
2017,Oct,13660,13339,321,2.3,"Todd County, MN"
2017,Nov,13692,13151,541,4.0,"Todd County, MN"
2017,Dec,13709,13047,662,4.8,"Todd County, MN"
2018,Jan,13567,12797,770,5.7,"Todd County, MN"
2018,Feb,13625,12900,725,5.3,"Todd County, MN"
2018,Mar,13653,12947,706,5.2,"Todd County, MN"
2018,Apr,13696,13122,574,4.2,"Todd County, MN"
2018,May,13596,13159,437,3.2,"Todd County, MN"
2018,Jun,13484,13047,437,3.2,"Todd County, MN"
2018,Jul,13542,13126,416,3.1,"Todd County, MN"
2018,Aug,13075,12661,414,3.2,"Todd County, MN"
2018,Sep,13241,12890,351,2.7,"Todd County, MN"
2018,Oct,13428,13027,401,3.0,"Todd County, MN"
2018,Nov,13409,12894,515,3.8,"Todd County, MN"
2018,Dec,13646,12888,758,5.6,"Todd County, MN"
2019,Jan,13498,12558,940,7.0,"Todd County, MN"
2019,Feb,13439,12586,853,6.3,"Todd County, MN"
2019,Mar,13524,12673,851,6.3,"Todd County, MN"
2019,Apr,13503,12892,611,4.5,"Todd County, MN"
2019,May,13607,13141,466,3.4,"Todd County, MN"
2019,Jun,13675,13170,505,3.7,"Todd County, MN"
2019,Jul,13732,13221,511,3.7,"Todd County, MN"
2019,Aug,13325,12869,456,3.4,"Todd County, MN"
2019,Sep,13510,13153,357,2.6,"Todd County, MN"
2019,Oct,13839,13452,387,2.8,"Todd County, MN"
2019,Nov,13755,13191,564,4.1,"Todd County, MN"
2019,Dec,13995,13224,771,5.5,"Todd County, MN"
2020,Jan,13605,12765,840,6.2,"Todd County, MN"
2020,Feb,13695,12918,777,5.7,"Todd County, MN"
2020,Mar,13637,12705,932,6.8,"Todd County, MN"
2020,Apr,13509,12687,822,6.1,"Todd County, MN"
2020,May,13501,12471,1030,7.6,"Todd County, MN"
2020,Jun,14119,13240,879,6.2,"Todd County, MN"
2020,Jul,14190,13465,725,5.1,"Todd County, MN"
2020,Aug,13931,13364,567,4.1,"Todd County, MN"
2020,Sep,13811,13291,520,3.8,"Todd County, MN"
2020,Oct,14338,13805,533,3.7,"Todd County, MN"
2020,Nov,14100,13448,652,4.6,"Todd County, MN"
2020,Dec,13940,13223,717,5.1,"Todd County, MN"
2021,Jan,13602,12773,829,6.1,"Todd County, MN"
2021,Feb,13550,12784,766,5.7,"Todd County, MN"
2021,Mar,13430,12694,736,5.5,"Todd County, MN"
2021,Apr,13347,12784,563,4.2,"Todd County, MN"
2021,May,13372,12899,473,3.5,"Todd County, MN"
2021,Jun,13541,12994,547,4.0,"Todd County, MN"
2021,Jul,13454,12975,479,3.6,"Todd County, MN"
2021,Aug,13388,12923,465,3.5,"Todd County, MN"
2021,Sep,13343,12974,369,2.8,"Todd County, MN"
2021,Oct,13485,13140,345,2.6,"Todd County, MN"
2021,Nov,13382,13012,370,2.8,"Todd County, MN"
2021,Dec,13666,13153,513,3.8,"Todd County, MN"
2022,Jan,13481,12844,637,4.7,"Todd County, MN"
2022,Feb,13520,12946,574,4.2,"Todd County, MN"
2022,Mar,13513,12989,524,3.9,"Todd County, MN"
2022,Apr,13371,12989,382,2.9,"Todd County, MN"
2022,May,13458,13154,304,2.3,"Todd County, MN"
2022,Jun,13494,13127,367,2.7,"Todd County, MN"
2022,Jul,13497,13160,337,2.5,"Todd County, MN"
2022,Aug,13403,13083,320,2.4,"Todd County, MN"
2022,Sep,13379,13107,272,2.0,"Todd County, MN"
2022,Oct,13676,13413,263,1.9,"Todd County, MN"
2022,Nov,13561,13172,389,2.9,"Todd County, MN"
2022,Dec,13668,13084,584,4.3,"Todd County, MN"
2023,Jan,13816,13131,685,5.0,"Todd County, MN"
2023,Feb,13922,13218,704,5.1,"Todd County, MN"
2023,Mar,13935,13288,647,4.6,"Todd County, MN"
2023,Apr,13633,13088,545,4.0,"Todd County, MN"
2023,May,13560,13165,395,2.9,"Todd County, MN"
2023,Jun,13626,13144,482,3.5,"Todd County, MN"
2023,Jul,13585,13130,455,3.3,"Todd County, MN"
2023,Aug,13821,13372,449,3.2,"Todd County, MN"
2023,Sep,13790,13466,324,2.3,"Todd County, MN"
2023,Oct,13966,13641,325,2.3,"Todd County, MN"
2023,Nov,13982,13600,382,2.7,"Todd County, MN"
2023,Dec,13793,13247,546,4.0,"Todd County, MN"
2024,Jan,13851,13163,688,5.0,"Todd County, MN"
2024,Feb,13887,13162,725,5.2,"Todd County, MN"
2024,Mar,14120,13473,647,4.6,"Todd County, MN"
2024,Apr,13949,13485,464,3.3,"Todd County, MN"
2024,May,13643,13223,420,3.1,"Todd County, MN"
2024,Jun,13970,13389,581,4.2,"Todd County, MN"
2024,Jul,13993,13414,579,4.1,"Todd County, MN"
2024,Aug,14391,13775,616,4.3,"Todd County, MN"
2024,Sep,14302,13878,424,3.0,"Todd County, MN"
2024,Oct,14297,13888,409,2.9,"Todd County, MN"
2024,Nov,14401(P),13823(P),578(P),4.0(P),"Todd County, MN"
P : Preliminary.,P : Preliminary.,P : Preliminary.,P : Preliminary.,P : Preliminary.,P : Preliminary.,"Todd County, MN"
2014,Jan,1582,1485,97,6.1,"Traverse County, MN"
2014,Feb,1580,1471,109,6.9,"Traverse County, MN"
2014,Mar,1596,1486,110,6.9,"Traverse County, MN"
2014,Apr,1676,1594,82,4.9,"Traverse County, MN"
2014,May,1695,1623,72,4.2,"Traverse County, MN"
2014,Jun,1746,1671,75,4.3,"Traverse County, MN"
2014,Jul,1774,1702,72,4.1,"Traverse County, MN"
2014,Aug,1777,1714,63,3.5,"Traverse County, MN"
2014,Sep,1732,1673,59,3.4,"Traverse County, MN"
2014,Oct,1836,1779,57,3.1,"Traverse County, MN"
2014,Nov,1801,1728,73,4.1,"Traverse County, MN"
2014,Dec,1791,1693,98,5.5,"Traverse County, MN"
2015,Jan,1845,1729,116,6.3,"Traverse County, MN"
2015,Feb,1768,1656,112,6.3,"Traverse County, MN"
2015,Mar,1863,1749,114,6.1,"Traverse County, MN"
2015,Apr,1805,1731,74,4.1,"Traverse County, MN"
2015,May,1799,1730,69,3.8,"Traverse County, MN"
2015,Jun,1914,1842,72,3.8,"Traverse County, MN"
2015,Jul,1843,1777,66,3.6,"Traverse County, MN"
2015,Aug,1800,1741,59,3.3,"Traverse County, MN"
2015,Sep,1779,1730,49,2.8,"Traverse County, MN"
2015,Oct,1934,1885,49,2.5,"Traverse County, MN"
2015,Nov,1872,1810,62,3.3,"Traverse County, MN"
2015,Dec,1850,1761,89,4.8,"Traverse County, MN"
2016,Jan,1777,1677,100,5.6,"Traverse County, MN"
2016,Feb,1669,1574,95,5.7,"Traverse County, MN"
2016,Mar,1743,1643,100,5.7,"Traverse County, MN"
2016,Apr,1689,1631,58,3.4,"Traverse County, MN"
2016,May,1669,1622,47,2.8,"Traverse County, MN"
2016,Jun,1698,1643,55,3.2,"Traverse County, MN"
2016,Jul,1664,1616,48,2.9,"Traverse County, MN"
2016,Aug,1644,1592,52,3.2,"Traverse County, MN"
2016,Sep,1607,1563,44,2.7,"Traverse County, MN"
2016,Oct,1752,1702,50,2.9,"Traverse County, MN"
2016,Nov,1790,1738,52,2.9,"Traverse County, MN"
2016,Dec,1764,1670,94,5.3,"Traverse County, MN"
2017,Jan,1865,1758,107,5.7,"Traverse County, MN"
2017,Feb,1776,1679,97,5.5,"Traverse County, MN"
2017,Mar,1789,1698,91,5.1,"Traverse County, MN"
2017,Apr,1806,1743,63,3.5,"Traverse County, MN"
2017,May,1794,1755,39,2.2,"Traverse County, MN"
2017,Jun,1790,1744,46,2.6,"Traverse County, MN"
2017,Jul,1743,1696,47,2.7,"Traverse County, MN"
2017,Aug,1677,1631,46,2.7,"Traverse County, MN"
2017,Sep,1703,1658,45,2.6,"Traverse County, MN"
2017,Oct,1805,1766,39,2.2,"Traverse County, MN"
2017,Nov,1802,1745,57,3.2,"Traverse County, MN"
2017,Dec,1804,1714,90,5.0,"Traverse County, MN"
2018,Jan,1769,1677,92,5.2,"Traverse County, MN"
2018,Feb,1762,1678,84,4.8,"Traverse County, MN"
2018,Mar,1775,1694,81,4.6,"Traverse County, MN"
2018,Apr,1807,1736,71,3.9,"Traverse County, MN"
2018,May,1849,1806,43,2.3,"Traverse County, MN"
2018,Jun,1818,1769,49,2.7,"Traverse County, MN"
2018,Jul,1784,1743,41,2.3,"Traverse County, MN"
2018,Aug,1674,1632,42,2.5,"Traverse County, MN"
2018,Sep,1713,1674,39,2.3,"Traverse County, MN"
2018,Oct,1795,1756,39,2.2,"Traverse County, MN"
2018,Nov,1777,1732,45,2.5,"Traverse County, MN"
2018,Dec,1804,1722,82,4.5,"Traverse County, MN"
2019,Jan,1735,1634,101,5.8,"Traverse County, MN"
2019,Feb,1708,1620,88,5.2,"Traverse County, MN"
2019,Mar,1723,1632,91,5.3,"Traverse County, MN"
2019,Apr,1790,1718,72,4.0,"Traverse County, MN"
2019,May,1857,1800,57,3.1,"Traverse County, MN"
2019,Jun,1857,1794,63,3.4,"Traverse County, MN"
2019,Jul,1811,1758,53,2.9,"Traverse County, MN"
2019,Aug,1710,1657,53,3.1,"Traverse County, MN"
2019,Sep,1735,1693,42,2.4,"Traverse County, MN"
2019,Oct,1841,1799,42,2.3,"Traverse County, MN"
2019,Nov,1766,1716,50,2.8,"Traverse County, MN"
2019,Dec,1749,1676,73,4.2,"Traverse County, MN"
2020,Jan,1691,1587,104,6.2,"Traverse County, MN"
2020,Feb,1656,1562,94,5.7,"Traverse County, MN"
2020,Mar,1664,1547,117,7.0,"Traverse County, MN"
2020,Apr,1774,1670,104,5.9,"Traverse County, MN"
2020,May,1735,1641,94,5.4,"Traverse County, MN"
2020,Jun,1829,1733,96,5.2,"Traverse County, MN"
2020,Jul,1864,1780,84,4.5,"Traverse County, MN"
2020,Aug,1755,1704,51,2.9,"Traverse County, MN"
2020,Sep,1739,1691,48,2.8,"Traverse County, MN"
2020,Oct,1880,1835,45,2.4,"Traverse County, MN"
2020,Nov,1774,1730,44,2.5,"Traverse County, MN"
2020,Dec,1809,1741,68,3.8,"Traverse County, MN"
2021,Jan,1695,1605,90,5.3,"Traverse County, MN"
2021,Feb,1674,1586,88,5.3,"Traverse County, MN"
2021,Mar,1635,1551,84,5.1,"Traverse County, MN"
2021,Apr,1644,1579,65,4.0,"Traverse County, MN"
2021,May,1667,1617,50,3.0,"Traverse County, MN"
2021,Jun,1671,1618,53,3.2,"Traverse County, MN"
2021,Jul,1684,1643,41,2.4,"Traverse County, MN"
2021,Aug,1653,1613,40,2.4,"Traverse County, MN"
2021,Sep,1633,1602,31,1.9,"Traverse County, MN"
2021,Oct,1675,1649,26,1.6,"Traverse County, MN"
2021,Nov,1632,1598,34,2.1,"Traverse County, MN"
2021,Dec,1714,1664,50,2.9,"Traverse County, MN"
2022,Jan,1654,1593,61,3.7,"Traverse County, MN"
2022,Feb,1646,1587,59,3.6,"Traverse County, MN"
2022,Mar,1622,1565,57,3.5,"Traverse County, MN"
2022,Apr,1588,1547,41,2.6,"Traverse County, MN"
2022,May,1621,1592,29,1.8,"Traverse County, MN"
2022,Jun,1634,1601,33,2.0,"Traverse County, MN"
2022,Jul,1661,1631,30,1.8,"Traverse County, MN"
2022,Aug,1616,1586,30,1.9,"Traverse County, MN"
2022,Sep,1589,1569,20,1.3,"Traverse County, MN"
2022,Oct,1667,1642,25,1.5,"Traverse County, MN"
2022,Nov,1623,1589,34,2.1,"Traverse County, MN"
2022,Dec,1698,1647,51,3.0,"Traverse County, MN"
2023,Jan,1633,1566,67,4.1,"Traverse County, MN"
2023,Feb,1649,1584,65,3.9,"Traverse County, MN"
2023,Mar,1631,1562,69,4.2,"Traverse County, MN"
2023,Apr,1579,1529,50,3.2,"Traverse County, MN"
2023,May,1589,1548,41,2.6,"Traverse County, MN"
2023,Jun,1594,1536,58,3.6,"Traverse County, MN"
2023,Jul,1597,1548,49,3.1,"Traverse County, MN"
2023,Aug,1669,1622,47,2.8,"Traverse County, MN"
2023,Sep,1635,1598,37,2.3,"Traverse County, MN"
2023,Oct,1677,1645,32,1.9,"Traverse County, MN"
2023,Nov,1670,1641,29,1.7,"Traverse County, MN"
2023,Dec,1611,1569,42,2.6,"Traverse County, MN"
2024,Jan,1580,1524,56,3.5,"Traverse County, MN"
2024,Feb,1565,1501,64,4.1,"Traverse County, MN"
2024,Mar,1618,1567,51,3.2,"Traverse County, MN"
2024,Apr,1626,1585,41,2.5,"Traverse County, MN"
2024,May,1565,1530,35,2.2,"Traverse County, MN"
2024,Jun,1671,1602,69,4.1,"Traverse County, MN"
2024,Jul,1688,1614,74,4.4,"Traverse County, MN"
2024,Aug,1779,1716,63,3.5,"Traverse County, MN"
2024,Sep,1746,1704,42,2.4,"Traverse County, MN"
2024,Oct,1726,1691,35,2.0,"Traverse County, MN"
2024,Nov,1739(P),1693(P),46(P),2.6(P),"Traverse County, MN"
P : Preliminary.,P : Preliminary.,P : Preliminary.,P : Preliminary.,P : Preliminary.,P : Preliminary.,"Traverse County, MN"
2014,Jan,11645,11012,633,5.4,"Wabasha County, MN"
2014,Feb,11591,10947,644,5.6,"Wabasha County, MN"
2014,Mar,11667,11028,639,5.5,"Wabasha County, MN"
2014,Apr,11580,11056,524,4.5,"Wabasha County, MN"
2014,May,11574,11126,448,3.9,"Wabasha County, MN"
2014,Jun,11797,11310,487,4.1,"Wabasha County, MN"
2014,Jul,12070,11591,479,4.0,"Wabasha County, MN"
2014,Aug,12031,11590,441,3.7,"Wabasha County, MN"
2014,Sep,11691,11317,374,3.2,"Wabasha County, MN"
2014,Oct,11858,11518,340,2.9,"Wabasha County, MN"
2014,Nov,11743,11385,358,3.0,"Wabasha County, MN"
2014,Dec,11781,11330,451,3.8,"Wabasha County, MN"
2015,Jan,11904,11331,573,4.8,"Wabasha County, MN"
2015,Feb,11743,11159,584,5.0,"Wabasha County, MN"
2015,Mar,12004,11392,612,5.1,"Wabasha County, MN"
2015,Apr,11837,11379,458,3.9,"Wabasha County, MN"
2015,May,11831,11383,448,3.8,"Wabasha County, MN"
2015,Jun,12190,11700,490,4.0,"Wabasha County, MN"
2015,Jul,12198,11750,448,3.7,"Wabasha County, MN"
2015,Aug,12093,11701,392,3.2,"Wabasha County, MN"
2015,Sep,11868,11522,346,2.9,"Wabasha County, MN"
2015,Oct,12256,11905,351,2.9,"Wabasha County, MN"
2015,Nov,12169,11791,378,3.1,"Wabasha County, MN"
2015,Dec,12155,11669,486,4.0,"Wabasha County, MN"
2016,Jan,12234,11625,609,5.0,"Wabasha County, MN"
2016,Feb,11977,11383,594,5.0,"Wabasha County, MN"
2016,Mar,12124,11552,572,4.7,"Wabasha County, MN"
2016,Apr,11923,11492,431,3.6,"Wabasha County, MN"
2016,May,11862,11494,368,3.1,"Wabasha County, MN"
2016,Jun,12028,11595,433,3.6,"Wabasha County, MN"
2016,Jul,12094,11697,397,3.3,"Wabasha County, MN"
2016,Aug,12010,11613,397,3.3,"Wabasha County, MN"
2016,Sep,11749,11399,350,3.0,"Wabasha County, MN"
2016,Oct,12063,11718,345,2.9,"Wabasha County, MN"
2016,Nov,12050,11675,375,3.1,"Wabasha County, MN"
2016,Dec,11969,11523,446,3.7,"Wabasha County, MN"
2017,Jan,12239,11658,581,4.7,"Wabasha County, MN"
2017,Feb,12092,11542,550,4.5,"Wabasha County, MN"
2017,Mar,12169,11643,526,4.3,"Wabasha County, MN"
2017,Apr,12199,11794,405,3.3,"Wabasha County, MN"
2017,May,12181,11816,365,3.0,"Wabasha County, MN"
2017,Jun,12357,11946,411,3.3,"Wabasha County, MN"
2017,Jul,12421,12038,383,3.1,"Wabasha County, MN"
2017,Aug,12215,11841,374,3.1,"Wabasha County, MN"
2017,Sep,12031,11717,314,2.6,"Wabasha County, MN"
2017,Oct,12269,11988,281,2.3,"Wabasha County, MN"
2017,Nov,12197,11871,326,2.7,"Wabasha County, MN"
2017,Dec,12240,11812,428,3.5,"Wabasha County, MN"
2018,Jan,12094,11576,518,4.3,"Wabasha County, MN"
2018,Feb,12156,11645,511,4.2,"Wabasha County, MN"
2018,Mar,12204,11708,496,4.1,"Wabasha County, MN"
2018,Apr,12156,11772,384,3.2,"Wabasha County, MN"
2018,May,12276,11986,290,2.4,"Wabasha County, MN"
2018,Jun,12366,11996,370,3.0,"Wabasha County, MN"
2018,Jul,12574,12235,339,2.7,"Wabasha County, MN"
2018,Aug,12175,11862,313,2.6,"Wabasha County, MN"
2018,Sep,12112,11855,257,2.1,"Wabasha County, MN"
2018,Oct,12249,11986,263,2.1,"Wabasha County, MN"
2018,Nov,12124,11829,295,2.4,"Wabasha County, MN"
2018,Dec,12245,11803,442,3.6,"Wabasha County, MN"
2019,Jan,12142,11573,569,4.7,"Wabasha County, MN"
2019,Feb,12034,11527,507,4.2,"Wabasha County, MN"
2019,Mar,12071,11575,496,4.1,"Wabasha County, MN"
2019,Apr,12155,11769,386,3.2,"Wabasha County, MN"
2019,May,12333,11982,351,2.8,"Wabasha County, MN"
2019,Jun,12414,12004,410,3.3,"Wabasha County, MN"
2019,Jul,12707,12311,396,3.1,"Wabasha County, MN"
2019,Aug,12415,12037,378,3.0,"Wabasha County, MN"
2019,Sep,12286,11983,303,2.5,"Wabasha County, MN"
2019,Oct,12513,12209,304,2.4,"Wabasha County, MN"
2019,Nov,12361,11962,399,3.2,"Wabasha County, MN"
2019,Dec,12482,11981,501,4.0,"Wabasha County, MN"
2020,Jan,12258,11675,583,4.8,"Wabasha County, MN"
2020,Feb,12270,11709,561,4.6,"Wabasha County, MN"
2020,Mar,12240,11568,672,5.5,"Wabasha County, MN"
2020,Apr,12172,11265,907,7.5,"Wabasha County, MN"
2020,May,12401,11152,1249,10.1,"Wabasha County, MN"
2020,Jun,12548,11600,948,7.6,"Wabasha County, MN"
2020,Jul,13005,12228,777,6.0,"Wabasha County, MN"
2020,Aug,12778,12231,547,4.3,"Wabasha County, MN"
2020,Sep,12522,12059,463,3.7,"Wabasha County, MN"
2020,Oct,12834,12425,409,3.2,"Wabasha County, MN"
2020,Nov,12548,12107,441,3.5,"Wabasha County, MN"
2020,Dec,12435,11894,541,4.4,"Wabasha County, MN"
2021,Jan,12265,11622,643,5.2,"Wabasha County, MN"
2021,Feb,12178,11597,581,4.8,"Wabasha County, MN"
2021,Mar,12033,11490,543,4.5,"Wabasha County, MN"
2021,Apr,12028,11629,399,3.3,"Wabasha County, MN"
2021,May,12092,11744,348,2.9,"Wabasha County, MN"
2021,Jun,12236,11817,419,3.4,"Wabasha County, MN"
2021,Jul,12505,12144,361,2.9,"Wabasha County, MN"
2021,Aug,12368,12013,355,2.9,"Wabasha County, MN"
2021,Sep,12103,11811,292,2.4,"Wabasha County, MN"
2021,Oct,12207,11950,257,2.1,"Wabasha County, MN"
2021,Nov,12085,11816,269,2.2,"Wabasha County, MN"
2021,Dec,12270,11948,322,2.6,"Wabasha County, MN"
2022,Jan,12219,11765,454,3.7,"Wabasha County, MN"
2022,Feb,12168,11764,404,3.3,"Wabasha County, MN"
2022,Mar,12105,11731,374,3.1,"Wabasha County, MN"
2022,Apr,11923,11680,243,2.0,"Wabasha County, MN"
2022,May,11987,11762,225,1.9,"Wabasha County, MN"
2022,Jun,12110,11803,307,2.5,"Wabasha County, MN"
2022,Jul,12436,12163,273,2.2,"Wabasha County, MN"
2022,Aug,12301,12015,286,2.3,"Wabasha County, MN"
2022,Sep,12057,11849,208,1.7,"Wabasha County, MN"
2022,Oct,12181,11962,219,1.8,"Wabasha County, MN"
2022,Nov,12017,11779,238,2.0,"Wabasha County, MN"
2022,Dec,12236,11869,367,3.0,"Wabasha County, MN"
2023,Jan,12232,11762,470,3.8,"Wabasha County, MN"
2023,Feb,12268,11794,474,3.9,"Wabasha County, MN"
2023,Mar,12280,11826,454,3.7,"Wabasha County, MN"
2023,Apr,12125,11798,327,2.7,"Wabasha County, MN"
2023,May,12120,11833,287,2.4,"Wabasha County, MN"
2023,Jun,12255,11873,382,3.1,"Wabasha County, MN"
2023,Jul,12412,12076,336,2.7,"Wabasha County, MN"
2023,Aug,12542,12209,333,2.7,"Wabasha County, MN"
2023,Sep,12330,12081,249,2.0,"Wabasha County, MN"
2023,Oct,12457,12232,225,1.8,"Wabasha County, MN"
2023,Nov,12423,12226,197,1.6,"Wabasha County, MN"
2023,Dec,12362,12060,302,2.4,"Wabasha County, MN"
2024,Jan,12492,12044,448,3.6,"Wabasha County, MN"
2024,Feb,12496,12006,490,3.9,"Wabasha County, MN"
2024,Mar,12607,12214,393,3.1,"Wabasha County, MN"
2024,Apr,12602,12287,315,2.5,"Wabasha County, MN"
2024,May,12426,12102,324,2.6,"Wabasha County, MN"
2024,Jun,12721,12305,416,3.3,"Wabasha County, MN"
2024,Jul,13064,12641,423,3.2,"Wabasha County, MN"
2024,Aug,13367,12959,408,3.1,"Wabasha County, MN"
2024,Sep,13229,12939,290,2.2,"Wabasha County, MN"
2024,Oct,13179,12937,242,1.8,"Wabasha County, MN"
2024,Nov,13267(P),12939(P),328(P),2.5(P),"Wabasha County, MN"
P : Preliminary.,P : Preliminary.,P : Preliminary.,P : Preliminary.,P : Preliminary.,P : Preliminary.,"Wabasha County, MN"
2014,Jan,6150,5591,559,9.1,"Wadena County, MN"
2014,Feb,6154,5598,556,9.0,"Wadena County, MN"
2014,Mar,6242,5707,535,8.6,"Wadena County, MN"
2014,Apr,6134,5716,418,6.8,"Wadena County, MN"
2014,May,6070,5743,327,5.4,"Wadena County, MN"
2014,Jun,6137,5794,343,5.6,"Wadena County, MN"
2014,Jul,6148,5823,325,5.3,"Wadena County, MN"
2014,Aug,6080,5773,307,5.0,"Wadena County, MN"
2014,Sep,6096,5816,280,4.6,"Wadena County, MN"
2014,Oct,6156,5900,256,4.2,"Wadena County, MN"
2014,Nov,6221,5876,345,5.5,"Wadena County, MN"
2014,Dec,6301,5866,435,6.9,"Wadena County, MN"
2015,Jan,6420,5892,528,8.2,"Wadena County, MN"
2015,Feb,6410,5878,532,8.3,"Wadena County, MN"
2015,Mar,6525,6006,519,8.0,"Wadena County, MN"
2015,Apr,6344,5975,369,5.8,"Wadena County, MN"
2015,May,6341,6011,330,5.2,"Wadena County, MN"
2015,Jun,6401,6042,359,5.6,"Wadena County, MN"
2015,Jul,6268,5941,327,5.2,"Wadena County, MN"
2015,Aug,6192,5892,300,4.8,"Wadena County, MN"
2015,Sep,6187,5921,266,4.3,"Wadena County, MN"
2015,Oct,6298,6028,270,4.3,"Wadena County, MN"
2015,Nov,6349,6001,348,5.5,"Wadena County, MN"
2015,Dec,6425,5972,453,7.1,"Wadena County, MN"
2016,Jan,6424,5904,520,8.1,"Wadena County, MN"
2016,Feb,6434,5907,527,8.2,"Wadena County, MN"
2016,Mar,6521,5981,540,8.3,"Wadena County, MN"
2016,Apr,6350,5975,375,5.9,"Wadena County, MN"
2016,May,6238,5949,289,4.6,"Wadena County, MN"
2016,Jun,6290,5944,346,5.5,"Wadena County, MN"
2016,Jul,6022,5715,307,5.1,"Wadena County, MN"
2016,Aug,6056,5749,307,5.1,"Wadena County, MN"
2016,Sep,6030,5763,267,4.4,"Wadena County, MN"
2016,Oct,6144,5874,270,4.4,"Wadena County, MN"
2016,Nov,6187,5896,291,4.7,"Wadena County, MN"
2016,Dec,6246,5838,408,6.5,"Wadena County, MN"
2017,Jan,6047,5506,541,8.9,"Wadena County, MN"
2017,Feb,6028,5515,513,8.5,"Wadena County, MN"
2017,Mar,5994,5546,448,7.5,"Wadena County, MN"
2017,Apr,5933,5614,319,5.4,"Wadena County, MN"
2017,May,5854,5610,244,4.2,"Wadena County, MN"
2017,Jun,5853,5579,274,4.7,"Wadena County, MN"
2017,Jul,5660,5413,247,4.4,"Wadena County, MN"
2017,Aug,5691,5431,260,4.6,"Wadena County, MN"
2017,Sep,5678,5472,206,3.6,"Wadena County, MN"
2017,Oct,5740,5547,193,3.4,"Wadena County, MN"
2017,Nov,5897,5592,305,5.2,"Wadena County, MN"
2017,Dec,5939,5539,400,6.7,"Wadena County, MN"
2018,Jan,5855,5394,461,7.9,"Wadena County, MN"
2018,Feb,5948,5490,458,7.7,"Wadena County, MN"
2018,Mar,5986,5532,454,7.6,"Wadena County, MN"
2018,Apr,6009,5641,368,6.1,"Wadena County, MN"
2018,May,5991,5755,236,3.9,"Wadena County, MN"
2018,Jun,5996,5715,281,4.7,"Wadena County, MN"
2018,Jul,5821,5583,238,4.1,"Wadena County, MN"
2018,Aug,5778,5546,232,4.0,"Wadena County, MN"
2018,Sep,5831,5640,191,3.3,"Wadena County, MN"
2018,Oct,5849,5641,208,3.6,"Wadena County, MN"
2018,Nov,5934,5662,272,4.6,"Wadena County, MN"
2018,Dec,6016,5598,418,6.9,"Wadena County, MN"
2019,Jan,6032,5480,552,9.2,"Wadena County, MN"
2019,Feb,5979,5460,519,8.7,"Wadena County, MN"
2019,Mar,5996,5479,517,8.6,"Wadena County, MN"
2019,Apr,5943,5568,375,6.3,"Wadena County, MN"
2019,May,5933,5672,261,4.4,"Wadena County, MN"
2019,Jun,5992,5683,309,5.2,"Wadena County, MN"
2019,Jul,5922,5501,421,7.1,"Wadena County, MN"
2019,Aug,5743,5466,277,4.8,"Wadena County, MN"
2019,Sep,5857,5646,211,3.6,"Wadena County, MN"
2019,Oct,5962,5740,222,3.7,"Wadena County, MN"
2019,Nov,6039,5725,314,5.2,"Wadena County, MN"
2019,Dec,6192,5699,493,8.0,"Wadena County, MN"
2020,Jan,6081,5505,576,9.5,"Wadena County, MN"
2020,Feb,6112,5573,539,8.8,"Wadena County, MN"
2020,Mar,6151,5529,622,10.1,"Wadena County, MN"
2020,Apr,5867,5192,675,11.5,"Wadena County, MN"
2020,May,5839,5218,621,10.6,"Wadena County, MN"
2020,Jun,6116,5617,499,8.2,"Wadena County, MN"
2020,Jul,6102,5667,435,7.1,"Wadena County, MN"
2020,Aug,6037,5711,326,5.4,"Wadena County, MN"
2020,Sep,6037,5737,300,5.0,"Wadena County, MN"
2020,Oct,6129,5803,326,5.3,"Wadena County, MN"
2020,Nov,5995,5686,309,5.2,"Wadena County, MN"
2020,Dec,6062,5646,416,6.9,"Wadena County, MN"
2021,Jan,6050,5565,485,8.0,"Wadena County, MN"
2021,Feb,6096,5653,443,7.3,"Wadena County, MN"
2021,Mar,6061,5647,414,6.8,"Wadena County, MN"
2021,Apr,6034,5732,302,5.0,"Wadena County, MN"
2021,May,6017,5775,242,4.0,"Wadena County, MN"
2021,Jun,5997,5724,273,4.6,"Wadena County, MN"
2021,Jul,5876,5658,218,3.7,"Wadena County, MN"
2021,Aug,5973,5765,208,3.5,"Wadena County, MN"
2021,Sep,5988,5799,189,3.2,"Wadena County, MN"
2021,Oct,6018,5836,182,3.0,"Wadena County, MN"
2021,Nov,6049,5862,187,3.1,"Wadena County, MN"
2021,Dec,6193,5905,288,4.7,"Wadena County, MN"
2022,Jan,6059,5682,377,6.2,"Wadena County, MN"
2022,Feb,6143,5793,350,5.7,"Wadena County, MN"
2022,Mar,6067,5760,307,5.1,"Wadena County, MN"
2022,Apr,6033,5808,225,3.7,"Wadena County, MN"
2022,May,6002,5831,171,2.8,"Wadena County, MN"
2022,Jun,6029,5826,203,3.4,"Wadena County, MN"
2022,Jul,5876,5690,186,3.2,"Wadena County, MN"
2022,Aug,6005,5811,194,3.2,"Wadena County, MN"
2022,Sep,6049,5895,154,2.5,"Wadena County, MN"
2022,Oct,6023,5867,156,2.6,"Wadena County, MN"
2022,Nov,6025,5822,203,3.4,"Wadena County, MN"
2022,Dec,6177,5838,339,5.5,"Wadena County, MN"
2023,Jan,6132,5719,413,6.7,"Wadena County, MN"
2023,Feb,6217,5790,427,6.9,"Wadena County, MN"
2023,Mar,6160,5767,393,6.4,"Wadena County, MN"
2023,Apr,6101,5795,306,5.0,"Wadena County, MN"
2023,May,6001,5785,216,3.6,"Wadena County, MN"
2023,Jun,6077,5798,279,4.6,"Wadena County, MN"
2023,Jul,5930,5621,309,5.2,"Wadena County, MN"
2023,Aug,6096,5792,304,5.0,"Wadena County, MN"
2023,Sep,6029,5872,157,2.6,"Wadena County, MN"
2023,Oct,6032,5862,170,2.8,"Wadena County, MN"
2023,Nov,6056,5880,176,2.9,"Wadena County, MN"
2023,Dec,6110,5817,293,4.8,"Wadena County, MN"
2024,Jan,6109,5703,406,6.6,"Wadena County, MN"
2024,Feb,6182,5750,432,7.0,"Wadena County, MN"
2024,Mar,6218,5837,381,6.1,"Wadena County, MN"
2024,Apr,6178,5894,284,4.6,"Wadena County, MN"
2024,May,6066,5788,278,4.6,"Wadena County, MN"
2024,Jun,6060,5755,305,5.0,"Wadena County, MN"
2024,Jul,5944,5630,314,5.3,"Wadena County, MN"
2024,Aug,6155,5836,319,5.2,"Wadena County, MN"
2024,Sep,6117,5928,189,3.1,"Wadena County, MN"
2024,Oct,6119,5919,200,3.3,"Wadena County, MN"
2024,Nov,6199(P),5929(P),270(P),4.4(P),"Wadena County, MN"
P : Preliminary.,P : Preliminary.,P : Preliminary.,P : Preliminary.,P : Preliminary.,P : Preliminary.,"Wadena County, MN"
2014,Jan,9584,8973,611,6.4,"Waseca County, MN"
2014,Feb,9598,8991,607,6.3,"Waseca County, MN"
2014,Mar,9602,8992,610,6.4,"Waseca County, MN"
2014,Apr,9527,9035,492,5.2,"Waseca County, MN"
2014,May,9559,9128,431,4.5,"Waseca County, MN"
2014,Jun,9792,9314,478,4.9,"Waseca County, MN"
2014,Jul,9793,9333,460,4.7,"Waseca County, MN"
2014,Aug,9835,9396,439,4.5,"Waseca County, MN"
2014,Sep,9691,9295,396,4.1,"Waseca County, MN"
2014,Oct,9978,9613,365,3.7,"Waseca County, MN"
2014,Nov,9718,9323,395,4.1,"Waseca County, MN"
2014,Dec,9664,9215,449,4.6,"Waseca County, MN"
2015,Jan,9682,9161,521,5.4,"Waseca County, MN"
2015,Feb,9586,9080,506,5.3,"Waseca County, MN"
2015,Mar,9656,9176,480,5.0,"Waseca County, MN"
2015,Apr,9625,9245,380,3.9,"Waseca County, MN"
2015,May,9655,9284,371,3.8,"Waseca County, MN"
2015,Jun,9888,9461,427,4.3,"Waseca County, MN"
2015,Jul,9898,9478,420,4.2,"Waseca County, MN"
2015,Aug,9928,9554,374,3.8,"Waseca County, MN"
2015,Sep,9804,9460,344,3.5,"Waseca County, MN"
2015,Oct,9997,9660,337,3.4,"Waseca County, MN"
2015,Nov,9840,9490,350,3.6,"Waseca County, MN"
2015,Dec,9756,9305,451,4.6,"Waseca County, MN"
2016,Jan,9573,9069,504,5.3,"Waseca County, MN"
2016,Feb,9443,8945,498,5.3,"Waseca County, MN"
2016,Mar,9520,9002,518,5.4,"Waseca County, MN"
2016,Apr,9411,9028,383,4.1,"Waseca County, MN"
2016,May,9366,9021,345,3.7,"Waseca County, MN"
2016,Jun,9542,9130,412,4.3,"Waseca County, MN"
2016,Jul,9482,9096,386,4.1,"Waseca County, MN"
2016,Aug,9510,9133,377,4.0,"Waseca County, MN"
2016,Sep,9453,9106,347,3.7,"Waseca County, MN"
2016,Oct,9528,9167,361,3.8,"Waseca County, MN"
2016,Nov,9368,9040,328,3.5,"Waseca County, MN"
2016,Dec,9339,8927,412,4.4,"Waseca County, MN"
2017,Jan,9427,8906,521,5.5,"Waseca County, MN"
2017,Feb,9356,8845,511,5.5,"Waseca County, MN"
2017,Mar,9404,8926,478,5.1,"Waseca County, MN"
2017,Apr,9330,8961,369,4.0,"Waseca County, MN"
2017,May,9287,8972,315,3.4,"Waseca County, MN"
2017,Jun,9462,9100,362,3.8,"Waseca County, MN"
2017,Jul,9353,9036,317,3.4,"Waseca County, MN"
2017,Aug,9294,8975,319,3.4,"Waseca County, MN"
2017,Sep,9322,9056,266,2.9,"Waseca County, MN"
2017,Oct,9443,9197,246,2.6,"Waseca County, MN"
2017,Nov,9210,8916,294,3.2,"Waseca County, MN"
2017,Dec,9165,8769,396,4.3,"Waseca County, MN"
2018,Jan,8995,8399,596,6.6,"Waseca County, MN"
2018,Feb,9008,8471,537,6.0,"Waseca County, MN"
2018,Mar,8993,8458,535,5.9,"Waseca County, MN"
2018,Apr,8975,8573,402,4.5,"Waseca County, MN"
2018,May,9044,8727,317,3.5,"Waseca County, MN"
2018,Jun,9165,8793,372,4.1,"Waseca County, MN"
2018,Jul,9072,8761,311,3.4,"Waseca County, MN"
2018,Aug,8925,8639,286,3.2,"Waseca County, MN"
2018,Sep,8980,8735,245,2.7,"Waseca County, MN"
2018,Oct,9099,8842,257,2.8,"Waseca County, MN"
2018,Nov,8735,8477,258,3.0,"Waseca County, MN"
2018,Dec,8837,8443,394,4.5,"Waseca County, MN"
2019,Jan,8755,8282,473,5.4,"Waseca County, MN"
2019,Feb,8746,8307,439,5.0,"Waseca County, MN"
2019,Mar,8815,8380,435,4.9,"Waseca County, MN"
2019,Apr,8951,8628,323,3.6,"Waseca County, MN"
2019,May,9090,8810,280,3.1,"Waseca County, MN"
2019,Jun,9284,8917,367,4.0,"Waseca County, MN"
2019,Jul,9266,8934,332,3.6,"Waseca County, MN"
2019,Aug,9182,8874,308,3.4,"Waseca County, MN"
2019,Sep,9174,8915,259,2.8,"Waseca County, MN"
2019,Oct,9437,9153,284,3.0,"Waseca County, MN"
2019,Nov,9152,8836,316,3.5,"Waseca County, MN"
2019,Dec,9087,8650,437,4.8,"Waseca County, MN"
2020,Jan,8947,8406,541,6.0,"Waseca County, MN"
2020,Feb,8918,8440,478,5.4,"Waseca County, MN"
2020,Mar,8909,8310,599,6.7,"Waseca County, MN"
2020,Apr,8863,8136,727,8.2,"Waseca County, MN"
2020,May,9003,8108,895,9.9,"Waseca County, MN"
2020,Jun,9427,8657,770,8.2,"Waseca County, MN"
2020,Jul,9540,8853,687,7.2,"Waseca County, MN"
2020,Aug,9441,8911,530,5.6,"Waseca County, MN"
2020,Sep,9338,8858,480,5.1,"Waseca County, MN"
2020,Oct,9595,9179,416,4.3,"Waseca County, MN"
2020,Nov,9213,8841,372,4.0,"Waseca County, MN"
2020,Dec,9005,8544,461,5.1,"Waseca County, MN"
2021,Jan,8865,8310,555,6.3,"Waseca County, MN"
2021,Feb,8810,8272,538,6.1,"Waseca County, MN"
2021,Mar,8748,8235,513,5.9,"Waseca County, MN"
2021,Apr,8780,8373,407,4.6,"Waseca County, MN"
2021,May,8805,8467,338,3.8,"Waseca County, MN"
2021,Jun,8987,8578,409,4.6,"Waseca County, MN"
2021,Jul,9082,8749,333,3.7,"Waseca County, MN"
2021,Aug,8997,8659,338,3.8,"Waseca County, MN"
2021,Sep,8888,8599,289,3.3,"Waseca County, MN"
2021,Oct,9052,8807,245,2.7,"Waseca County, MN"
2021,Nov,8718,8505,213,2.4,"Waseca County, MN"
2021,Dec,8701,8407,294,3.4,"Waseca County, MN"
2022,Jan,8628,8236,392,4.5,"Waseca County, MN"
2022,Feb,8632,8273,359,4.2,"Waseca County, MN"
2022,Mar,8535,8191,344,4.0,"Waseca County, MN"
2022,Apr,8552,8299,253,3.0,"Waseca County, MN"
2022,May,8547,8319,228,2.7,"Waseca County, MN"
2022,Jun,8593,8305,288,3.4,"Waseca County, MN"
2022,Jul,8776,8511,265,3.0,"Waseca County, MN"
2022,Aug,8709,8438,271,3.1,"Waseca County, MN"
2022,Sep,8629,8421,208,2.4,"Waseca County, MN"
2022,Oct,8713,8509,204,2.3,"Waseca County, MN"
2022,Nov,8504,8258,246,2.9,"Waseca County, MN"
2022,Dec,8566,8211,355,4.1,"Waseca County, MN"
2023,Jan,8558,8102,456,5.3,"Waseca County, MN"
2023,Feb,8623,8141,482,5.6,"Waseca County, MN"
2023,Mar,8509,8070,439,5.2,"Waseca County, MN"
2023,Apr,8512,8184,328,3.9,"Waseca County, MN"
2023,May,8513,8214,299,3.5,"Waseca County, MN"
2023,Jun,8643,8278,365,4.2,"Waseca County, MN"
2023,Jul,8600,8286,314,3.7,"Waseca County, MN"
2023,Aug,8782,8449,333,3.8,"Waseca County, MN"
2023,Sep,8648,8423,225,2.6,"Waseca County, MN"
2023,Oct,8716,8484,232,2.7,"Waseca County, MN"
2023,Nov,8492,8279,213,2.5,"Waseca County, MN"
2023,Dec,8324,8021,303,3.6,"Waseca County, MN"
2024,Jan,8309,7874,435,5.2,"Waseca County, MN"
2024,Feb,8316,7846,470,5.7,"Waseca County, MN"
2024,Mar,8384,7961,423,5.0,"Waseca County, MN"
2024,Apr,8418,8087,331,3.9,"Waseca County, MN"
2024,May,8262,7948,314,3.8,"Waseca County, MN"
2024,Jun,8529,8095,434,5.1,"Waseca County, MN"
2024,Jul,8588,8186,402,4.7,"Waseca County, MN"
2024,Aug,8814,8406,408,4.6,"Waseca County, MN"
2024,Sep,8694,8407,287,3.3,"Waseca County, MN"
2024,Oct,8679,8414,265,3.1,"Waseca County, MN"
2024,Nov,8516(P),8195(P),321(P),3.8(P),"Waseca County, MN"
P : Preliminary.,P : Preliminary.,P : Preliminary.,P : Preliminary.,P : Preliminary.,P : Preliminary.,"Waseca County, MN"
2014,Jan,134697,128547,6150,4.6,"Washington County, MN"
2014,Feb,135091,128847,6244,4.6,"Washington County, MN"
2014,Mar,135517,129355,6162,4.5,"Washington County, MN"
2014,Apr,135691,130732,4959,3.7,"Washington County, MN"
2014,May,136569,131776,4793,3.5,"Washington County, MN"
2014,Jun,137627,132265,5362,3.9,"Washington County, MN"
2014,Jul,138135,132889,5246,3.8,"Washington County, MN"
2014,Aug,136890,131969,4921,3.6,"Washington County, MN"
2014,Sep,136370,131813,4557,3.3,"Washington County, MN"
2014,Oct,136727,132574,4153,3.0,"Washington County, MN"
2014,Nov,136718,132623,4095,3.0,"Washington County, MN"
2014,Dec,136127,131757,4370,3.2,"Washington County, MN"
2015,Jan,135728,130425,5303,3.9,"Washington County, MN"
2015,Feb,136380,131280,5100,3.7,"Washington County, MN"
2015,Mar,136010,131048,4962,3.6,"Washington County, MN"
2015,Apr,137141,133051,4090,3.0,"Washington County, MN"
2015,May,138655,134359,4296,3.1,"Washington County, MN"
2015,Jun,138589,133785,4804,3.5,"Washington County, MN"
2015,Jul,139513,134905,4608,3.3,"Washington County, MN"
2015,Aug,138342,134021,4321,3.1,"Washington County, MN"
2015,Sep,137175,133157,4018,2.9,"Washington County, MN"
2015,Oct,137113,133268,3845,2.8,"Washington County, MN"
2015,Nov,137442,133756,3686,2.7,"Washington County, MN"
2015,Dec,137485,133220,4265,3.1,"Washington County, MN"
2016,Jan,136796,131755,5041,3.7,"Washington County, MN"
2016,Feb,138075,132981,5094,3.7,"Washington County, MN"
2016,Mar,137897,132745,5152,3.7,"Washington County, MN"
2016,Apr,138454,134170,4284,3.1,"Washington County, MN"
2016,May,138742,134656,4086,2.9,"Washington County, MN"
2016,Jun,139133,134114,5019,3.6,"Washington County, MN"
2016,Jul,140658,135954,4704,3.3,"Washington County, MN"
2016,Aug,139955,135265,4690,3.4,"Washington County, MN"
2016,Sep,139556,135073,4483,3.2,"Washington County, MN"
2016,Oct,138739,134433,4306,3.1,"Washington County, MN"
2016,Nov,138479,134445,4034,2.9,"Washington County, MN"
2016,Dec,138316,133661,4655,3.4,"Washington County, MN"
2017,Jan,139137,133818,5319,3.8,"Washington County, MN"
2017,Feb,140343,135028,5315,3.8,"Washington County, MN"
2017,Mar,140726,135915,4811,3.4,"Washington County, MN"
2017,Apr,141109,136967,4142,2.9,"Washington County, MN"
2017,May,141332,137234,4098,2.9,"Washington County, MN"
2017,Jun,142746,138028,4718,3.3,"Washington County, MN"
2017,Jul,143610,139289,4321,3.0,"Washington County, MN"
2017,Aug,142735,138410,4325,3.0,"Washington County, MN"
2017,Sep,142848,139047,3801,2.7,"Washington County, MN"
2017,Oct,141216,137891,3325,2.4,"Washington County, MN"
2017,Nov,141651,138225,3426,2.4,"Washington County, MN"
2017,Dec,141232,137357,3875,2.7,"Washington County, MN"
2018,Jan,141783,137391,4392,3.1,"Washington County, MN"
2018,Feb,142984,138611,4373,3.1,"Washington County, MN"
2018,Mar,142324,138048,4276,3.0,"Washington County, MN"
2018,Apr,141847,138300,3547,2.5,"Washington County, MN"
2018,May,142296,139111,3185,2.2,"Washington County, MN"
2018,Jun,143520,139507,4013,2.8,"Washington County, MN"
2018,Jul,143949,140424,3525,2.4,"Washington County, MN"
2018,Aug,142955,139458,3497,2.4,"Washington County, MN"
2018,Sep,142627,139371,3256,2.3,"Washington County, MN"
2018,Oct,142696,139594,3102,2.2,"Washington County, MN"
2018,Nov,143088,140021,3067,2.1,"Washington County, MN"
2018,Dec,143292,139279,4013,2.8,"Washington County, MN"
2019,Jan,144288,139478,4810,3.3,"Washington County, MN"
2019,Feb,144883,140304,4579,3.2,"Washington County, MN"
2019,Mar,144642,139901,4741,3.3,"Washington County, MN"
2019,Apr,144240,140483,3757,2.6,"Washington County, MN"
2019,May,144731,140828,3903,2.7,"Washington County, MN"
2019,Jun,146425,141714,4711,3.2,"Washington County, MN"
2019,Jul,146735,142433,4302,2.9,"Washington County, MN"
2019,Aug,146393,142275,4118,2.8,"Washington County, MN"
2019,Sep,146045,142365,3680,2.5,"Washington County, MN"
2019,Oct,145870,142227,3643,2.5,"Washington County, MN"
2019,Nov,145967,142455,3512,2.4,"Washington County, MN"
2019,Dec,146365,142273,4092,2.8,"Washington County, MN"
2020,Jan,147728,143144,4584,3.1,"Washington County, MN"
2020,Feb,148348,143780,4568,3.1,"Washington County, MN"
2020,Mar,147849,141745,6104,4.1,"Washington County, MN"
2020,Apr,139817,128322,11495,8.2,"Washington County, MN"
2020,May,141858,126610,15248,10.7,"Washington County, MN"
2020,Jun,147584,134867,12717,8.6,"Washington County, MN"
2020,Jul,148579,137421,11158,7.5,"Washington County, MN"
2020,Aug,148081,139598,8483,5.7,"Washington County, MN"
2020,Sep,146633,139069,7564,5.2,"Washington County, MN"
2020,Oct,146132,140017,6115,4.2,"Washington County, MN"
2020,Nov,145274,140119,5155,3.5,"Washington County, MN"
2020,Dec,143036,136867,6169,4.3,"Washington County, MN"
2021,Jan,141294,135131,6163,4.4,"Washington County, MN"
2021,Feb,141504,135765,5739,4.1,"Washington County, MN"
2021,Mar,141775,136198,5577,3.9,"Washington County, MN"
2021,Apr,141961,137159,4802,3.4,"Washington County, MN"
2021,May,142156,137615,4541,3.2,"Washington County, MN"
2021,Jun,142747,137268,5479,3.8,"Washington County, MN"
2021,Jul,143152,138697,4455,3.1,"Washington County, MN"
2021,Aug,142240,137830,4410,3.1,"Washington County, MN"
2021,Sep,141648,137699,3949,2.8,"Washington County, MN"
2021,Oct,142040,138711,3329,2.3,"Washington County, MN"
2021,Nov,142946,140019,2927,2.0,"Washington County, MN"
2021,Dec,142980,139698,3282,2.3,"Washington County, MN"
2022,Jan,142985,139132,3853,2.7,"Washington County, MN"
2022,Feb,143201,139820,3381,2.4,"Washington County, MN"
2022,Mar,143778,140323,3455,2.4,"Washington County, MN"
2022,Apr,144223,141758,2465,1.7,"Washington County, MN"
2022,May,144959,142339,2620,1.8,"Washington County, MN"
2022,Jun,145204,141700,3504,2.4,"Washington County, MN"
2022,Jul,145648,142429,3219,2.2,"Washington County, MN"
2022,Aug,145398,142013,3385,2.3,"Washington County, MN"
2022,Sep,144715,141942,2773,1.9,"Washington County, MN"
2022,Oct,143688,140896,2792,1.9,"Washington County, MN"
2022,Nov,143616,140836,2780,1.9,"Washington County, MN"
2022,Dec,144027,140634,3393,2.4,"Washington County, MN"
2023,Jan,143890,140253,3637,2.5,"Washington County, MN"
2023,Feb,144549,140606,3943,2.7,"Washington County, MN"
2023,Mar,145335,141501,3834,2.6,"Washington County, MN"
2023,Apr,145565,142227,3338,2.3,"Washington County, MN"
2023,May,146471,142935,3536,2.4,"Washington County, MN"
2023,Jun,147992,143571,4421,3.0,"Washington County, MN"
2023,Jul,147863,143822,4041,2.7,"Washington County, MN"
2023,Aug,146637,142377,4260,2.9,"Washington County, MN"
2023,Sep,145755,142569,3186,2.2,"Washington County, MN"
2023,Oct,145103,142106,2997,2.1,"Washington County, MN"
2023,Nov,144832,142459,2373,1.6,"Washington County, MN"
2023,Dec,143952,140895,3057,2.1,"Washington County, MN"
2024,Jan,144517,140642,3875,2.7,"Washington County, MN"
2024,Feb,145463,141049,4414,3.0,"Washington County, MN"
2024,Mar,145485,141646,3839,2.6,"Washington County, MN"
2024,Apr,145498,142144,3354,2.3,"Washington County, MN"
2024,May,145091,141608,3483,2.4,"Washington County, MN"
2024,Jun,145112,140036,5076,3.5,"Washington County, MN"
2024,Jul,145458,140296,5162,3.5,"Washington County, MN"
2024,Aug,144597,139260,5337,3.7,"Washington County, MN"
2024,Sep,144009,140052,3957,2.7,"Washington County, MN"
2024,Oct,144171,140635,3536,2.5,"Washington County, MN"
2024,Nov,143847(P),140080(P),3767(P),2.6(P),"Washington County, MN"
P : Preliminary.,P : Preliminary.,P : Preliminary.,P : Preliminary.,P : Preliminary.,P : Preliminary.,"Washington County, MN"
2014,Jan,6133,5732,401,6.5,"Watonwan County, MN"
2014,Feb,6111,5711,400,6.5,"Watonwan County, MN"
2014,Mar,6157,5770,387,6.3,"Watonwan County, MN"
2014,Apr,6136,5817,319,5.2,"Watonwan County, MN"
2014,May,6122,5852,270,4.4,"Watonwan County, MN"
2014,Jun,6283,5946,337,5.4,"Watonwan County, MN"
2014,Jul,6109,5822,287,4.7,"Watonwan County, MN"
2014,Aug,6112,5846,266,4.4,"Watonwan County, MN"
2014,Sep,6076,5843,233,3.8,"Watonwan County, MN"
2014,Oct,6272,6001,271,4.3,"Watonwan County, MN"
2014,Nov,6235,5978,257,4.1,"Watonwan County, MN"
2014,Dec,6358,6053,305,4.8,"Watonwan County, MN"
2015,Jan,6345,5961,384,6.1,"Watonwan County, MN"
2015,Feb,6179,5806,373,6.0,"Watonwan County, MN"
2015,Mar,6359,5981,378,5.9,"Watonwan County, MN"
2015,Apr,6199,5931,268,4.3,"Watonwan County, MN"
2015,May,6174,5908,266,4.3,"Watonwan County, MN"
2015,Jun,6456,6161,295,4.6,"Watonwan County, MN"
2015,Jul,6012,5721,291,4.8,"Watonwan County, MN"
2015,Aug,5995,5749,246,4.1,"Watonwan County, MN"
2015,Sep,6091,5866,225,3.7,"Watonwan County, MN"
2015,Oct,6467,6207,260,4.0,"Watonwan County, MN"
2015,Nov,6391,6120,271,4.2,"Watonwan County, MN"
2015,Dec,6545,6207,338,5.2,"Watonwan County, MN"
2016,Jan,6729,6345,384,5.7,"Watonwan County, MN"
2016,Feb,6499,6122,377,5.8,"Watonwan County, MN"
2016,Mar,6685,6292,393,5.9,"Watonwan County, MN"
2016,Apr,6563,6259,304,4.6,"Watonwan County, MN"
2016,May,6532,6267,265,4.1,"Watonwan County, MN"
2016,Jun,6642,6329,313,4.7,"Watonwan County, MN"
2016,Jul,6413,6074,339,5.3,"Watonwan County, MN"
2016,Aug,6392,6098,294,4.6,"Watonwan County, MN"
2016,Sep,6401,6116,285,4.5,"Watonwan County, MN"
2016,Oct,6731,6402,329,4.9,"Watonwan County, MN"
2016,Nov,6638,6382,256,3.9,"Watonwan County, MN"
2016,Dec,6650,6355,295,4.4,"Watonwan County, MN"
2017,Jan,6757,6343,414,6.1,"Watonwan County, MN"
2017,Feb,6530,6160,370,5.7,"Watonwan County, MN"
2017,Mar,6631,6255,376,5.7,"Watonwan County, MN"
2017,Apr,6632,6339,293,4.4,"Watonwan County, MN"
2017,May,6526,6296,230,3.5,"Watonwan County, MN"
2017,Jun,6544,6285,259,4.0,"Watonwan County, MN"
2017,Jul,6413,6162,251,3.9,"Watonwan County, MN"
2017,Aug,6297,6001,296,4.7,"Watonwan County, MN"
2017,Sep,6296,6044,252,4.0,"Watonwan County, MN"
2017,Oct,6581,6383,198,3.0,"Watonwan County, MN"
2017,Nov,6573,6351,222,3.4,"Watonwan County, MN"
2017,Dec,6578,6324,254,3.9,"Watonwan County, MN"
2018,Jan,6511,6178,333,5.1,"Watonwan County, MN"
2018,Feb,6484,6173,311,4.8,"Watonwan County, MN"
2018,Mar,6510,6196,314,4.8,"Watonwan County, MN"
2018,Apr,6598,6365,233,3.5,"Watonwan County, MN"
2018,May,6609,6422,187,2.8,"Watonwan County, MN"
2018,Jun,6642,6425,217,3.3,"Watonwan County, MN"
2018,Jul,6663,6448,215,3.2,"Watonwan County, MN"
2018,Aug,6254,6065,189,3.0,"Watonwan County, MN"
2018,Sep,6325,6167,158,2.5,"Watonwan County, MN"
2018,Oct,6566,6401,165,2.5,"Watonwan County, MN"
2018,Nov,6532,6345,187,2.9,"Watonwan County, MN"
2018,Dec,6664,6385,279,4.2,"Watonwan County, MN"
2019,Jan,6437,6063,374,5.8,"Watonwan County, MN"
2019,Feb,6359,6031,328,5.2,"Watonwan County, MN"
2019,Mar,6416,6074,342,5.3,"Watonwan County, MN"
2019,Apr,6580,6306,274,4.2,"Watonwan County, MN"
2019,May,6712,6483,229,3.4,"Watonwan County, MN"
2019,Jun,6710,6439,271,4.0,"Watonwan County, MN"
2019,Jul,6658,6391,267,4.0,"Watonwan County, MN"
2019,Aug,6383,6129,254,4.0,"Watonwan County, MN"
2019,Sep,6317,6135,182,2.9,"Watonwan County, MN"
2019,Oct,6770,6565,205,3.0,"Watonwan County, MN"
2019,Nov,6592,6367,225,3.4,"Watonwan County, MN"
2019,Dec,6584,6324,260,3.9,"Watonwan County, MN"
2020,Jan,6492,6157,335,5.2,"Watonwan County, MN"
2020,Feb,6411,6111,300,4.7,"Watonwan County, MN"
2020,Mar,6382,6015,367,5.8,"Watonwan County, MN"
2020,Apr,6706,6350,356,5.3,"Watonwan County, MN"
2020,May,6624,6180,444,6.7,"Watonwan County, MN"
2020,Jun,6829,6408,421,6.2,"Watonwan County, MN"
2020,Jul,6918,6543,375,5.4,"Watonwan County, MN"
2020,Aug,6717,6445,272,4.0,"Watonwan County, MN"
2020,Sep,6618,6386,232,3.5,"Watonwan County, MN"
2020,Oct,7012,6784,228,3.3,"Watonwan County, MN"
2020,Nov,6794,6592,202,3.0,"Watonwan County, MN"
2020,Dec,6815,6575,240,3.5,"Watonwan County, MN"
2021,Jan,6600,6293,307,4.7,"Watonwan County, MN"
2021,Feb,6530,6227,303,4.6,"Watonwan County, MN"
2021,Mar,6535,6236,299,4.6,"Watonwan County, MN"
2021,Apr,6484,6261,223,3.4,"Watonwan County, MN"
2021,May,6545,6344,201,3.1,"Watonwan County, MN"
2021,Jun,6596,6354,242,3.7,"Watonwan County, MN"
2021,Jul,6759,6515,244,3.6,"Watonwan County, MN"
2021,Aug,6504,6311,193,3.0,"Watonwan County, MN"
2021,Sep,6306,6162,144,2.3,"Watonwan County, MN"
2021,Oct,6593,6472,121,1.8,"Watonwan County, MN"
2021,Nov,6551,6442,109,1.7,"Watonwan County, MN"
2021,Dec,6699,6554,145,2.2,"Watonwan County, MN"
2022,Jan,6561,6367,194,3.0,"Watonwan County, MN"
2022,Feb,6561,6375,186,2.8,"Watonwan County, MN"
2022,Mar,6491,6301,190,2.9,"Watonwan County, MN"
2022,Apr,6335,6189,146,2.3,"Watonwan County, MN"
2022,May,6392,6255,137,2.1,"Watonwan County, MN"
2022,Jun,6452,6285,167,2.6,"Watonwan County, MN"
2022,Jul,6680,6488,192,2.9,"Watonwan County, MN"
2022,Aug,6491,6336,155,2.4,"Watonwan County, MN"
2022,Sep,6386,6282,104,1.6,"Watonwan County, MN"
2022,Oct,6646,6538,108,1.6,"Watonwan County, MN"
2022,Nov,6639,6513,126,1.9,"Watonwan County, MN"
2022,Dec,6698,6513,185,2.8,"Watonwan County, MN"
2023,Jan,6609,6392,217,3.3,"Watonwan County, MN"
2023,Feb,6690,6437,253,3.8,"Watonwan County, MN"
2023,Mar,6669,6425,244,3.7,"Watonwan County, MN"
2023,Apr,6519,6324,195,3.0,"Watonwan County, MN"
2023,May,6502,6336,166,2.6,"Watonwan County, MN"
2023,Jun,6606,6366,240,3.6,"Watonwan County, MN"
2023,Jul,6665,6431,234,3.5,"Watonwan County, MN"
2023,Aug,6727,6540,187,2.8,"Watonwan County, MN"
2023,Sep,6641,6472,169,2.5,"Watonwan County, MN"
2023,Oct,6828,6707,121,1.8,"Watonwan County, MN"
2023,Nov,6860,6753,107,1.6,"Watonwan County, MN"
2023,Dec,6698,6536,162,2.4,"Watonwan County, MN"
2024,Jan,6668,6449,219,3.3,"Watonwan County, MN"
2024,Feb,6663,6423,240,3.6,"Watonwan County, MN"
2024,Mar,6778,6546,232,3.4,"Watonwan County, MN"
2024,Apr,6732,6549,183,2.7,"Watonwan County, MN"
2024,May,6578,6398,180,2.7,"Watonwan County, MN"
2024,Jun,6837,6580,257,3.8,"Watonwan County, MN"
2024,Jul,6973,6699,274,3.9,"Watonwan County, MN"
2024,Aug,7086,6835,251,3.5,"Watonwan County, MN"
2024,Sep,6975,6790,185,2.7,"Watonwan County, MN"
2024,Oct,7050,6901,149,2.1,"Watonwan County, MN"
2024,Nov,7052(P),6882(P),170(P),2.4(P),"Watonwan County, MN"
P : Preliminary.,P : Preliminary.,P : Preliminary.,P : Preliminary.,P : Preliminary.,P : Preliminary.,"Watonwan County, MN"
2014,Jan,3541,3378,163,4.6,"Wilkin County, MN"
2014,Feb,3543,3379,164,4.6,"Wilkin County, MN"
2014,Mar,3557,3412,145,4.1,"Wilkin County, MN"
2014,Apr,3533,3418,115,3.3,"Wilkin County, MN"
2014,May,3559,3446,113,3.2,"Wilkin County, MN"
2014,Jun,3581,3455,126,3.5,"Wilkin County, MN"
2014,Jul,3619,3493,126,3.5,"Wilkin County, MN"
2014,Aug,3571,3451,120,3.4,"Wilkin County, MN"
2014,Sep,3586,3481,105,2.9,"Wilkin County, MN"
2014,Oct,3731,3636,95,2.5,"Wilkin County, MN"
2014,Nov,3713,3618,95,2.6,"Wilkin County, MN"
2014,Dec,3662,3530,132,3.6,"Wilkin County, MN"
2015,Jan,3727,3555,172,4.6,"Wilkin County, MN"
2015,Feb,3623,3469,154,4.3,"Wilkin County, MN"
2015,Mar,3727,3576,151,4.1,"Wilkin County, MN"
2015,Apr,3669,3551,118,3.2,"Wilkin County, MN"
2015,May,3601,3478,123,3.4,"Wilkin County, MN"
2015,Jun,3721,3584,137,3.7,"Wilkin County, MN"
2015,Jul,3676,3541,135,3.7,"Wilkin County, MN"
2015,Aug,3625,3514,111,3.1,"Wilkin County, MN"
2015,Sep,3605,3510,95,2.6,"Wilkin County, MN"
2015,Oct,3897,3809,88,2.3,"Wilkin County, MN"
2015,Nov,3793,3694,99,2.6,"Wilkin County, MN"
2015,Dec,3711,3595,116,3.1,"Wilkin County, MN"
2016,Jan,3817,3661,156,4.1,"Wilkin County, MN"
2016,Feb,3710,3559,151,4.1,"Wilkin County, MN"
2016,Mar,3777,3626,151,4.0,"Wilkin County, MN"
2016,Apr,3704,3601,103,2.8,"Wilkin County, MN"
2016,May,3647,3549,98,2.7,"Wilkin County, MN"
2016,Jun,3720,3589,131,3.5,"Wilkin County, MN"
2016,Jul,3651,3531,120,3.3,"Wilkin County, MN"
2016,Aug,3608,3487,121,3.4,"Wilkin County, MN"
2016,Sep,3620,3526,94,2.6,"Wilkin County, MN"
2016,Oct,3855,3767,88,2.3,"Wilkin County, MN"
2016,Nov,3806,3711,95,2.5,"Wilkin County, MN"
2016,Dec,3702,3558,144,3.9,"Wilkin County, MN"
2017,Jan,3639,3472,167,4.6,"Wilkin County, MN"
2017,Feb,3580,3421,159,4.4,"Wilkin County, MN"
2017,Mar,3609,3463,146,4.0,"Wilkin County, MN"
2017,Apr,3607,3508,99,2.7,"Wilkin County, MN"
2017,May,3584,3488,96,2.7,"Wilkin County, MN"
2017,Jun,3591,3467,124,3.5,"Wilkin County, MN"
2017,Jul,3547,3433,114,3.2,"Wilkin County, MN"
2017,Aug,3420,3311,109,3.2,"Wilkin County, MN"
2017,Sep,3478,3395,83,2.4,"Wilkin County, MN"
2017,Oct,3696,3628,68,1.8,"Wilkin County, MN"
2017,Nov,3539,3466,73,2.1,"Wilkin County, MN"
2017,Dec,3527,3416,111,3.1,"Wilkin County, MN"
2018,Jan,3466,3331,135,3.9,"Wilkin County, MN"
2018,Feb,3515,3373,142,4.0,"Wilkin County, MN"
2018,Mar,3526,3397,129,3.7,"Wilkin County, MN"
2018,Apr,3526,3418,108,3.1,"Wilkin County, MN"
2018,May,3581,3502,79,2.2,"Wilkin County, MN"
2018,Jun,3572,3464,108,3.0,"Wilkin County, MN"
2018,Jul,3577,3463,114,3.2,"Wilkin County, MN"
2018,Aug,3371,3273,98,2.9,"Wilkin County, MN"
2018,Sep,3525,3433,92,2.6,"Wilkin County, MN"
2018,Oct,3640,3554,86,2.4,"Wilkin County, MN"
2018,Nov,3490,3404,86,2.5,"Wilkin County, MN"
2018,Dec,3518,3385,133,3.8,"Wilkin County, MN"
2019,Jan,3428,3253,175,5.1,"Wilkin County, MN"
2019,Feb,3418,3263,155,4.5,"Wilkin County, MN"
2019,Mar,3432,3281,151,4.4,"Wilkin County, MN"
2019,Apr,3493,3378,115,3.3,"Wilkin County, MN"
2019,May,3598,3498,100,2.8,"Wilkin County, MN"
2019,Jun,3615,3482,133,3.7,"Wilkin County, MN"
2019,Jul,3602,3471,131,3.6,"Wilkin County, MN"
2019,Aug,3492,3369,123,3.5,"Wilkin County, MN"
2019,Sep,3475,3395,80,2.3,"Wilkin County, MN"
2019,Oct,3698,3612,86,2.3,"Wilkin County, MN"
2019,Nov,3536,3456,80,2.3,"Wilkin County, MN"
2019,Dec,3580,3460,120,3.4,"Wilkin County, MN"
2020,Jan,3359,3226,133,4.0,"Wilkin County, MN"
2020,Feb,3374,3249,125,3.7,"Wilkin County, MN"
2020,Mar,3351,3196,155,4.6,"Wilkin County, MN"
2020,Apr,3390,3187,203,6.0,"Wilkin County, MN"
2020,May,3448,3236,212,6.1,"Wilkin County, MN"
2020,Jun,3553,3362,191,5.4,"Wilkin County, MN"
2020,Jul,3601,3432,169,4.7,"Wilkin County, MN"
2020,Aug,3493,3385,108,3.1,"Wilkin County, MN"
2020,Sep,3494,3391,103,2.9,"Wilkin County, MN"
2020,Oct,3739,3635,104,2.8,"Wilkin County, MN"
2020,Nov,3507,3390,117,3.3,"Wilkin County, MN"
2020,Dec,3503,3377,126,3.6,"Wilkin County, MN"
2021,Jan,3419,3268,151,4.4,"Wilkin County, MN"
2021,Feb,3398,3261,137,4.0,"Wilkin County, MN"
2021,Mar,3354,3217,137,4.1,"Wilkin County, MN"
2021,Apr,3347,3239,108,3.2,"Wilkin County, MN"
2021,May,3374,3280,94,2.8,"Wilkin County, MN"
2021,Jun,3427,3305,122,3.6,"Wilkin County, MN"
2021,Jul,3427,3317,110,3.2,"Wilkin County, MN"
2021,Aug,3385,3290,95,2.8,"Wilkin County, MN"
2021,Sep,3356,3278,78,2.3,"Wilkin County, MN"
2021,Oct,3513,3447,66,1.9,"Wilkin County, MN"
2021,Nov,3466,3408,58,1.7,"Wilkin County, MN"
2021,Dec,3441,3370,71,2.1,"Wilkin County, MN"
2022,Jan,3401,3301,100,2.9,"Wilkin County, MN"
2022,Feb,3397,3309,88,2.6,"Wilkin County, MN"
2022,Mar,3402,3318,84,2.5,"Wilkin County, MN"
2022,Apr,3326,3265,61,1.8,"Wilkin County, MN"
2022,May,3337,3280,57,1.7,"Wilkin County, MN"
2022,Jun,3376,3294,82,2.4,"Wilkin County, MN"
2022,Jul,3410,3331,79,2.3,"Wilkin County, MN"
2022,Aug,3322,3242,80,2.4,"Wilkin County, MN"
2022,Sep,3369,3317,52,1.5,"Wilkin County, MN"
2022,Oct,3511,3463,48,1.4,"Wilkin County, MN"
2022,Nov,3338,3286,52,1.6,"Wilkin County, MN"
2022,Dec,3447,3362,85,2.5,"Wilkin County, MN"
2023,Jan,3382,3281,101,3.0,"Wilkin County, MN"
2023,Feb,3419,3318,101,3.0,"Wilkin County, MN"
2023,Mar,3409,3317,92,2.7,"Wilkin County, MN"
2023,Apr,3350,3273,77,2.3,"Wilkin County, MN"
2023,May,3371,3285,86,2.6,"Wilkin County, MN"
2023,Jun,3364,3263,101,3.0,"Wilkin County, MN"
2023,Jul,3327,3222,105,3.2,"Wilkin County, MN"
2023,Aug,3459,3358,101,2.9,"Wilkin County, MN"
2023,Sep,3469,3402,67,1.9,"Wilkin County, MN"
2023,Oct,3586,3528,58,1.6,"Wilkin County, MN"
2023,Nov,3481,3432,49,1.4,"Wilkin County, MN"
2023,Dec,3387,3320,67,2.0,"Wilkin County, MN"
2024,Jan,3362,3272,90,2.7,"Wilkin County, MN"
2024,Feb,3367,3264,103,3.1,"Wilkin County, MN"
2024,Mar,3455,3370,85,2.5,"Wilkin County, MN"
2024,Apr,3465,3384,81,2.3,"Wilkin County, MN"
2024,May,3366,3284,82,2.4,"Wilkin County, MN"
2024,Jun,3501,3376,125,3.6,"Wilkin County, MN"
2024,Jul,3552,3387,165,4.6,"Wilkin County, MN"
2024,Aug,3648,3527,121,3.3,"Wilkin County, MN"
2024,Sep,3653,3576,77,2.1,"Wilkin County, MN"
2024,Oct,3685,3619,66,1.8,"Wilkin County, MN"
2024,Nov,3636(P),3546(P),90(P),2.5(P),"Wilkin County, MN"
P : Preliminary.,P : Preliminary.,P : Preliminary.,P : Preliminary.,P : Preliminary.,P : Preliminary.,"Wilkin County, MN"
2014,Jan,29079,27645,1434,4.9,"Winona County, MN"
2014,Feb,29358,27933,1425,4.9,"Winona County, MN"
2014,Mar,29328,27969,1359,4.6,"Winona County, MN"
2014,Apr,29455,28395,1060,3.6,"Winona County, MN"
2014,May,29473,28384,1089,3.7,"Winona County, MN"
2014,Jun,29298,28045,1253,4.3,"Winona County, MN"
2014,Jul,29293,28082,1211,4.1,"Winona County, MN"
2014,Aug,29102,28038,1064,3.7,"Winona County, MN"
2014,Sep,29393,28458,935,3.2,"Winona County, MN"
2014,Oct,29909,29037,872,2.9,"Winona County, MN"
2014,Nov,29682,28866,816,2.7,"Winona County, MN"
2014,Dec,29540,28581,959,3.2,"Winona County, MN"
2015,Jan,29669,28476,1193,4.0,"Winona County, MN"
2015,Feb,29690,28574,1116,3.8,"Winona County, MN"
2015,Mar,29654,28543,1111,3.7,"Winona County, MN"
2015,Apr,29793,28890,903,3.0,"Winona County, MN"
2015,May,29756,28778,978,3.3,"Winona County, MN"
2015,Jun,29446,28286,1160,3.9,"Winona County, MN"
2015,Jul,29243,28133,1110,3.8,"Winona County, MN"
2015,Aug,29132,28124,1008,3.5,"Winona County, MN"
2015,Sep,29242,28369,873,3.0,"Winona County, MN"
2015,Oct,29800,28960,840,2.8,"Winona County, MN"
2015,Nov,29634,28873,761,2.6,"Winona County, MN"
2015,Dec,29420,28467,953,3.2,"Winona County, MN"
2016,Jan,29550,28438,1112,3.8,"Winona County, MN"
2016,Feb,29528,28400,1128,3.8,"Winona County, MN"
2016,Mar,29564,28434,1130,3.8,"Winona County, MN"
2016,Apr,29687,28776,911,3.1,"Winona County, MN"
2016,May,29415,28473,942,3.2,"Winona County, MN"
2016,Jun,29136,27916,1220,4.2,"Winona County, MN"
2016,Jul,28773,27650,1123,3.9,"Winona County, MN"
2016,Aug,28973,27917,1056,3.6,"Winona County, MN"
2016,Sep,29002,28038,964,3.3,"Winona County, MN"
2016,Oct,29272,28311,961,3.3,"Winona County, MN"
2016,Nov,29160,28295,865,3.0,"Winona County, MN"
2016,Dec,28930,27903,1027,3.5,"Winona County, MN"
2017,Jan,29117,27946,1171,4.0,"Winona County, MN"
2017,Feb,29388,28232,1156,3.9,"Winona County, MN"
2017,Mar,29411,28355,1056,3.6,"Winona County, MN"
2017,Apr,29473,28587,886,3.0,"Winona County, MN"
2017,May,29286,28386,900,3.1,"Winona County, MN"
2017,Jun,29096,28025,1071,3.7,"Winona County, MN"
2017,Jul,28765,27808,957,3.3,"Winona County, MN"
2017,Aug,28699,27782,917,3.2,"Winona County, MN"
2017,Sep,29101,28319,782,2.7,"Winona County, MN"
2017,Oct,29021,28366,655,2.3,"Winona County, MN"
2017,Nov,29014,28379,635,2.2,"Winona County, MN"
2017,Dec,28842,28064,778,2.7,"Winona County, MN"
2018,Jan,28620,27739,881,3.1,"Winona County, MN"
2018,Feb,29018,28078,940,3.2,"Winona County, MN"
2018,Mar,29103,28216,887,3.0,"Winona County, MN"
2018,Apr,29252,28562,690,2.4,"Winona County, MN"
2018,May,28852,28140,712,2.5,"Winona County, MN"
2018,Jun,28538,27609,929,3.3,"Winona County, MN"
2018,Jul,28569,27771,798,2.8,"Winona County, MN"
2018,Aug,28164,27376,788,2.8,"Winona County, MN"
2018,Sep,28668,27990,678,2.4,"Winona County, MN"
2018,Oct,28655,28047,608,2.1,"Winona County, MN"
2018,Nov,28708,28130,578,2.0,"Winona County, MN"
2018,Dec,28642,27818,824,2.9,"Winona County, MN"
2019,Jan,28433,27499,934,3.3,"Winona County, MN"
2019,Feb,28731,27847,884,3.1,"Winona County, MN"
2019,Mar,28866,27922,944,3.3,"Winona County, MN"
2019,Apr,28889,28154,735,2.5,"Winona County, MN"
2019,May,29118,28310,808,2.8,"Winona County, MN"
2019,Jun,28622,27622,1000,3.5,"Winona County, MN"
2019,Jul,28716,27779,937,3.3,"Winona County, MN"
2019,Aug,28551,27681,870,3.0,"Winona County, MN"
2019,Sep,28898,28178,720,2.5,"Winona County, MN"
2019,Oct,28905,28223,682,2.4,"Winona County, MN"
2019,Nov,28806,28088,718,2.5,"Winona County, MN"
2019,Dec,28568,27727,841,2.9,"Winona County, MN"
2020,Jan,28287,27330,957,3.4,"Winona County, MN"
2020,Feb,28603,27676,927,3.2,"Winona County, MN"
2020,Mar,28376,27145,1231,4.3,"Winona County, MN"
2020,Apr,27251,25217,2034,7.5,"Winona County, MN"
2020,May,27866,25435,2431,8.7,"Winona County, MN"
2020,Jun,28383,26377,2006,7.1,"Winona County, MN"
2020,Jul,29077,27184,1893,6.5,"Winona County, MN"
2020,Aug,28830,27438,1392,4.8,"Winona County, MN"
2020,Sep,28694,27527,1167,4.1,"Winona County, MN"
2020,Oct,28954,27932,1022,3.5,"Winona County, MN"
2020,Nov,28598,27708,890,3.1,"Winona County, MN"
2020,Dec,27906,26815,1091,3.9,"Winona County, MN"
2021,Jan,27835,26677,1158,4.2,"Winona County, MN"
2021,Feb,28064,27013,1051,3.7,"Winona County, MN"
2021,Mar,28054,27013,1041,3.7,"Winona County, MN"
2021,Apr,28219,27359,860,3.0,"Winona County, MN"
2021,May,27943,27040,903,3.2,"Winona County, MN"
2021,Jun,27536,26453,1083,3.9,"Winona County, MN"
2021,Jul,27811,26875,936,3.4,"Winona County, MN"
2021,Aug,27803,26973,830,3.0,"Winona County, MN"
2021,Sep,28080,27386,694,2.5,"Winona County, MN"
2021,Oct,28275,27674,601,2.1,"Winona County, MN"
2021,Nov,28242,27709,533,1.9,"Winona County, MN"
2021,Dec,28165,27535,630,2.2,"Winona County, MN"
2022,Jan,28136,27375,761,2.7,"Winona County, MN"
2022,Feb,28368,27717,651,2.3,"Winona County, MN"
2022,Mar,28523,27855,668,2.3,"Winona County, MN"
2022,Apr,28372,27930,442,1.6,"Winona County, MN"
2022,May,28208,27709,499,1.8,"Winona County, MN"
2022,Jun,27696,27023,673,2.4,"Winona County, MN"
2022,Jul,28080,27472,608,2.2,"Winona County, MN"
2022,Aug,28128,27482,646,2.3,"Winona County, MN"
2022,Sep,28399,27938,461,1.6,"Winona County, MN"
2022,Oct,28460,28008,452,1.6,"Winona County, MN"
2022,Nov,28358,27865,493,1.7,"Winona County, MN"
2022,Dec,28608,27935,673,2.4,"Winona County, MN"
2023,Jan,28470,27735,735,2.6,"Winona County, MN"
2023,Feb,28757,27984,773,2.7,"Winona County, MN"
2023,Mar,28893,28167,726,2.5,"Winona County, MN"
2023,Apr,28800,28209,591,2.1,"Winona County, MN"
2023,May,28431,27753,678,2.4,"Winona County, MN"
2023,Jun,28231,27410,821,2.9,"Winona County, MN"
2023,Jul,28208,27452,756,2.7,"Winona County, MN"
2023,Aug,28461,27650,811,2.8,"Winona County, MN"
2023,Sep,28481,27907,574,2.0,"Winona County, MN"
2023,Oct,28497,27961,536,1.9,"Winona County, MN"
2023,Nov,28401,27971,430,1.5,"Winona County, MN"
2023,Dec,28059,27465,594,2.1,"Winona County, MN"
2024,Jan,28161,27400,761,2.7,"Winona County, MN"
2024,Feb,28408,27546,862,3.0,"Winona County, MN"
2024,Mar,28508,27830,678,2.4,"Winona County, MN"
2024,Apr,28580,27985,595,2.1,"Winona County, MN"
2024,May,27870,27234,636,2.3,"Winona County, MN"
2024,Jun,27695,26732,963,3.5,"Winona County, MN"
2024,Jul,27962,27004,958,3.4,"Winona County, MN"
2024,Aug,28305,27365,940,3.3,"Winona County, MN"
2024,Sep,28464,27803,661,2.3,"Winona County, MN"
2024,Oct,28469,27880,589,2.1,"Winona County, MN"
2024,Nov,28525(P),27876(P),649(P),2.3(P),"Winona County, MN"
P : Preliminary.,P : Preliminary.,P : Preliminary.,P : Preliminary.,P : Preliminary.,P : Preliminary.,"Winona County, MN"
2014,Jan,70915,66838,4077,5.7,"Wright County, MN"
2014,Feb,71073,66943,4130,5.8,"Wright County, MN"
2014,Mar,71314,67222,4092,5.7,"Wright County, MN"
2014,Apr,71156,67913,3243,4.6,"Wright County, MN"
2014,May,71171,68442,2729,3.8,"Wright County, MN"
2014,Jun,71688,68721,2967,4.1,"Wright County, MN"
2014,Jul,72034,69177,2857,4.0,"Wright County, MN"
2014,Aug,71399,68731,2668,3.7,"Wright County, MN"
2014,Sep,70998,68598,2400,3.4,"Wright County, MN"
2014,Oct,71279,69049,2230,3.1,"Wright County, MN"
2014,Nov,71634,69044,2590,3.6,"Wright County, MN"
2014,Dec,71571,68600,2971,4.2,"Wright County, MN"
2015,Jan,71741,68164,3577,5.0,"Wright County, MN"
2015,Feb,71933,68461,3472,4.8,"Wright County, MN"
2015,Mar,71884,68474,3410,4.7,"Wright County, MN"
2015,Apr,71952,69402,2550,3.5,"Wright County, MN"
2015,May,72473,70006,2467,3.4,"Wright County, MN"
2015,Jun,72551,69854,2697,3.7,"Wright County, MN"
2015,Jul,72922,70376,2546,3.5,"Wright County, MN"
2015,Aug,72299,69941,2358,3.3,"Wright County, MN"
2015,Sep,71609,69442,2167,3.0,"Wright County, MN"
2015,Oct,71833,69705,2128,3.0,"Wright County, MN"
2015,Nov,72065,69866,2199,3.1,"Wright County, MN"
2015,Dec,72549,69627,2922,4.0,"Wright County, MN"
2016,Jan,72667,69133,3534,4.9,"Wright County, MN"
2016,Feb,73172,69632,3540,4.8,"Wright County, MN"
2016,Mar,73132,69518,3614,4.9,"Wright County, MN"
2016,Apr,72949,70228,2721,3.7,"Wright County, MN"
2016,May,72781,70488,2293,3.2,"Wright County, MN"
2016,Jun,72994,70264,2730,3.7,"Wright County, MN"
2016,Jul,73820,71205,2615,3.5,"Wright County, MN"
2016,Aug,73364,70802,2562,3.5,"Wright County, MN"
2016,Sep,73054,70653,2401,3.3,"Wright County, MN"
2016,Oct,72844,70468,2376,3.3,"Wright County, MN"
2016,Nov,72744,70446,2298,3.2,"Wright County, MN"
2016,Dec,73200,70078,3122,4.3,"Wright County, MN"
2017,Jan,73900,70173,3727,5.0,"Wright County, MN"
2017,Feb,74279,70665,3614,4.9,"Wright County, MN"
2017,Mar,74468,71068,3400,4.6,"Wright County, MN"
2017,Apr,74248,71646,2602,3.5,"Wright County, MN"
2017,May,74090,71819,2271,3.1,"Wright County, MN"
2017,Jun,74851,72241,2610,3.5,"Wright County, MN"
2017,Jul,75384,72967,2417,3.2,"Wright County, MN"
2017,Aug,74826,72414,2412,3.2,"Wright County, MN"
2017,Sep,74809,72709,2100,2.8,"Wright County, MN"
2017,Oct,74164,72295,1869,2.5,"Wright County, MN"
2017,Nov,74466,72390,2076,2.8,"Wright County, MN"
2017,Dec,74657,71967,2690,3.6,"Wright County, MN"
2018,Jan,75372,72196,3176,4.2,"Wright County, MN"
2018,Feb,75896,72786,3110,4.1,"Wright County, MN"
2018,Mar,75497,72415,3082,4.1,"Wright County, MN"
2018,Apr,75074,72632,2442,3.3,"Wright County, MN"
2018,May,74994,73189,1805,2.4,"Wright County, MN"
2018,Jun,75521,73359,2162,2.9,"Wright County, MN"
2018,Jul,75958,74027,1931,2.5,"Wright County, MN"
2018,Aug,75216,73273,1943,2.6,"Wright County, MN"
2018,Sep,75014,73264,1750,2.3,"Wright County, MN"
2018,Oct,75156,73431,1725,2.3,"Wright County, MN"
2018,Nov,75342,73534,1808,2.4,"Wright County, MN"
2018,Dec,75953,73210,2743,3.6,"Wright County, MN"
2019,Jan,76916,73357,3559,4.6,"Wright County, MN"
2019,Feb,77036,73733,3303,4.3,"Wright County, MN"
2019,Mar,76766,73505,3261,4.2,"Wright County, MN"
2019,Apr,76419,73919,2500,3.3,"Wright County, MN"
2019,May,76326,74272,2054,2.7,"Wright County, MN"
2019,Jun,77130,74707,2423,3.1,"Wright County, MN"
2019,Jul,77590,75339,2251,2.9,"Wright County, MN"
2019,Aug,77167,75053,2114,2.7,"Wright County, MN"
2019,Sep,76933,75043,1890,2.5,"Wright County, MN"
2019,Oct,77039,75088,1951,2.5,"Wright County, MN"
2019,Nov,77233,75078,2155,2.8,"Wright County, MN"
2019,Dec,77807,74935,2872,3.7,"Wright County, MN"
2020,Jan,78814,75418,3396,4.3,"Wright County, MN"
2020,Feb,79052,75789,3263,4.1,"Wright County, MN"
2020,Mar,78634,74600,4034,5.1,"Wright County, MN"
2020,Apr,73806,67758,6048,8.2,"Wright County, MN"
2020,May,74257,66955,7302,9.8,"Wright County, MN"
2020,Jun,77392,71459,5933,7.7,"Wright County, MN"
2020,Jul,78160,72978,5182,6.6,"Wright County, MN"
2020,Aug,77942,74084,3858,4.9,"Wright County, MN"
2020,Sep,77100,73626,3474,4.5,"Wright County, MN"
2020,Oct,77259,74271,2988,3.9,"Wright County, MN"
2020,Nov,77084,74166,2918,3.8,"Wright County, MN"
2020,Dec,75956,72404,3552,4.7,"Wright County, MN"
2021,Jan,75269,71378,3891,5.2,"Wright County, MN"
2021,Feb,75458,71699,3759,5.0,"Wright County, MN"
2021,Mar,75161,71698,3463,4.6,"Wright County, MN"
2021,Apr,74951,72261,2690,3.6,"Wright County, MN"
2021,May,74889,72605,2284,3.0,"Wright County, MN"
2021,Jun,75223,72485,2738,3.6,"Wright County, MN"
2021,Jul,75725,73485,2240,3.0,"Wright County, MN"
2021,Aug,75314,73065,2249,3.0,"Wright County, MN"
2021,Sep,74791,72842,1949,2.6,"Wright County, MN"
2021,Oct,75188,73472,1716,2.3,"Wright County, MN"
2021,Nov,75539,73972,1567,2.1,"Wright County, MN"
2021,Dec,75906,73779,2127,2.8,"Wright County, MN"
2022,Jan,76071,73347,2724,3.6,"Wright County, MN"
2022,Feb,76162,73730,2432,3.2,"Wright County, MN"
2022,Mar,76104,73801,2303,3.0,"Wright County, MN"
2022,Apr,76157,74576,1581,2.1,"Wright County, MN"
2022,May,76332,74966,1366,1.8,"Wright County, MN"
2022,Jun,76389,74610,1779,2.3,"Wright County, MN"
2022,Jul,76882,75257,1625,2.1,"Wright County, MN"
2022,Aug,76756,75022,1734,2.3,"Wright County, MN"
2022,Sep,76252,74856,1396,1.8,"Wright County, MN"
2022,Oct,75918,74471,1447,1.9,"Wright County, MN"
2022,Nov,75956,74292,1664,2.2,"Wright County, MN"
2022,Dec,76726,74199,2527,3.3,"Wright County, MN"
2023,Jan,76995,74006,2989,3.9,"Wright County, MN"
2023,Feb,77257,74158,3099,4.0,"Wright County, MN"
2023,Mar,77394,74448,2946,3.8,"Wright County, MN"
2023,Apr,77274,74946,2328,3.0,"Wright County, MN"
2023,May,77139,75257,1882,2.4,"Wright County, MN"
2023,Jun,78065,75525,2540,3.3,"Wright County, MN"
2023,Jul,78080,75812,2268,2.9,"Wright County, MN"
2023,Aug,77656,75268,2388,3.1,"Wright County, MN"
2023,Sep,76967,75308,1659,2.2,"Wright County, MN"
2023,Oct,76721,75155,1566,2.0,"Wright County, MN"
2023,Nov,76681,75289,1392,1.8,"Wright County, MN"
2023,Dec,76555,74438,2117,2.8,"Wright County, MN"
2024,Jan,77049,74193,2856,3.7,"Wright County, MN"
2024,Feb,77527,74374,3153,4.1,"Wright County, MN"
2024,Mar,77522,74749,2773,3.6,"Wright County, MN"
2024,Apr,77267,75095,2172,2.8,"Wright County, MN"
2024,May,76930,74681,2249,2.9,"Wright County, MN"
2024,Jun,76839,73823,3016,3.9,"Wright County, MN"
2024,Jul,77171,74126,3045,3.9,"Wright County, MN"
2024,Aug,76918,73877,3041,4.0,"Wright County, MN"
2024,Sep,76313,74186,2127,2.8,"Wright County, MN"
2024,Oct,76421,74500,1921,2.5,"Wright County, MN"
2024,Nov,76447(P),74213(P),2234(P),2.9(P),"Wright County, MN"
P : Preliminary.,P : Preliminary.,P : Preliminary.,P : Preliminary.,P : Preliminary.,P : Preliminary.,"Wright County, MN"
2014,Jan,5472,5142,330,6.0,"Yellow Medicine County, MN"
2014,Feb,5447,5119,328,6.0,"Yellow Medicine County, MN"
2014,Mar,5476,5156,320,5.8,"Yellow Medicine County, MN"
2014,Apr,5430,5203,227,4.2,"Yellow Medicine County, MN"
2014,May,5432,5236,196,3.6,"Yellow Medicine County, MN"
2014,Jun,5548,5325,223,4.0,"Yellow Medicine County, MN"
2014,Jul,5550,5329,221,4.0,"Yellow Medicine County, MN"
2014,Aug,5444,5245,199,3.7,"Yellow Medicine County, MN"
2014,Sep,5422,5259,163,3.0,"Yellow Medicine County, MN"
2014,Oct,5606,5447,159,2.8,"Yellow Medicine County, MN"
2014,Nov,5562,5371,191,3.4,"Yellow Medicine County, MN"
2014,Dec,5604,5363,241,4.3,"Yellow Medicine County, MN"
2015,Jan,5626,5321,305,5.4,"Yellow Medicine County, MN"
2015,Feb,5513,5230,283,5.1,"Yellow Medicine County, MN"
2015,Mar,5663,5378,285,5.0,"Yellow Medicine County, MN"
2015,Apr,5542,5360,182,3.3,"Yellow Medicine County, MN"
2015,May,5516,5331,185,3.4,"Yellow Medicine County, MN"
2015,Jun,5718,5513,205,3.6,"Yellow Medicine County, MN"
2015,Jul,5522,5324,198,3.6,"Yellow Medicine County, MN"
2015,Aug,5395,5212,183,3.4,"Yellow Medicine County, MN"
2015,Sep,5407,5257,150,2.8,"Yellow Medicine County, MN"
2015,Oct,5740,5599,141,2.5,"Yellow Medicine County, MN"
2015,Nov,5669,5517,152,2.7,"Yellow Medicine County, MN"
2015,Dec,5753,5507,246,4.3,"Yellow Medicine County, MN"
2016,Jan,5636,5355,281,5.0,"Yellow Medicine County, MN"
2016,Feb,5446,5178,268,4.9,"Yellow Medicine County, MN"
2016,Mar,5555,5285,270,4.9,"Yellow Medicine County, MN"
2016,Apr,5465,5263,202,3.7,"Yellow Medicine County, MN"
2016,May,5472,5297,175,3.2,"Yellow Medicine County, MN"
2016,Jun,5537,5328,209,3.8,"Yellow Medicine County, MN"
2016,Jul,5390,5177,213,4.0,"Yellow Medicine County, MN"
2016,Aug,5269,5081,188,3.6,"Yellow Medicine County, MN"
2016,Sep,5238,5082,156,3.0,"Yellow Medicine County, MN"
2016,Oct,5548,5386,162,2.9,"Yellow Medicine County, MN"
2016,Nov,5554,5396,158,2.8,"Yellow Medicine County, MN"
2016,Dec,5586,5353,233,4.2,"Yellow Medicine County, MN"
2017,Jan,5494,5225,269,4.9,"Yellow Medicine County, MN"
2017,Feb,5385,5134,251,4.7,"Yellow Medicine County, MN"
2017,Mar,5441,5210,231,4.2,"Yellow Medicine County, MN"
2017,Apr,5328,5160,168,3.2,"Yellow Medicine County, MN"
2017,May,5330,5173,157,2.9,"Yellow Medicine County, MN"
2017,Jun,5441,5239,202,3.7,"Yellow Medicine County, MN"
2017,Jul,5292,5124,168,3.2,"Yellow Medicine County, MN"
2017,Aug,5168,4987,181,3.5,"Yellow Medicine County, MN"
2017,Sep,5203,5059,144,2.8,"Yellow Medicine County, MN"
2017,Oct,5488,5354,134,2.4,"Yellow Medicine County, MN"
2017,Nov,5454,5303,151,2.8,"Yellow Medicine County, MN"
2017,Dec,5490,5288,202,3.7,"Yellow Medicine County, MN"
2018,Jan,5327,5090,237,4.4,"Yellow Medicine County, MN"
2018,Feb,5356,5139,217,4.1,"Yellow Medicine County, MN"
2018,Mar,5340,5121,219,4.1,"Yellow Medicine County, MN"
2018,Apr,5341,5187,154,2.9,"Yellow Medicine County, MN"
2018,May,5425,5300,125,2.3,"Yellow Medicine County, MN"
2018,Jun,5445,5284,161,3.0,"Yellow Medicine County, MN"
2018,Jul,5374,5227,147,2.7,"Yellow Medicine County, MN"
2018,Aug,5131,4994,137,2.7,"Yellow Medicine County, MN"
2018,Sep,5281,5167,114,2.2,"Yellow Medicine County, MN"
2018,Oct,5407,5288,119,2.2,"Yellow Medicine County, MN"
2018,Nov,5361,5224,137,2.6,"Yellow Medicine County, MN"
2018,Dec,5436,5227,209,3.8,"Yellow Medicine County, MN"
2019,Jan,5301,5042,259,4.9,"Yellow Medicine County, MN"
2019,Feb,5257,5021,236,4.5,"Yellow Medicine County, MN"
2019,Mar,5278,5003,275,5.2,"Yellow Medicine County, MN"
2019,Apr,5349,5118,231,4.3,"Yellow Medicine County, MN"
2019,May,5468,5275,193,3.5,"Yellow Medicine County, MN"
2019,Jun,5507,5281,226,4.1,"Yellow Medicine County, MN"
2019,Jul,5504,5287,217,3.9,"Yellow Medicine County, MN"
2019,Aug,5257,5070,187,3.6,"Yellow Medicine County, MN"
2019,Sep,5352,5207,145,2.7,"Yellow Medicine County, MN"
2019,Oct,5510,5356,154,2.8,"Yellow Medicine County, MN"
2019,Nov,5355,5205,150,2.8,"Yellow Medicine County, MN"
2019,Dec,5450,5236,214,3.9,"Yellow Medicine County, MN"
2020,Jan,5169,4928,241,4.7,"Yellow Medicine County, MN"
2020,Feb,5163,4921,242,4.7,"Yellow Medicine County, MN"
2020,Mar,5157,4884,273,5.3,"Yellow Medicine County, MN"
2020,Apr,5287,4904,383,7.2,"Yellow Medicine County, MN"
2020,May,5259,4904,355,6.8,"Yellow Medicine County, MN"
2020,Jun,5487,5208,279,5.1,"Yellow Medicine County, MN"
2020,Jul,5498,5238,260,4.7,"Yellow Medicine County, MN"
2020,Aug,5329,5130,199,3.7,"Yellow Medicine County, MN"
2020,Sep,5299,5131,168,3.2,"Yellow Medicine County, MN"
2020,Oct,5570,5405,165,3.0,"Yellow Medicine County, MN"
2020,Nov,5375,5202,173,3.2,"Yellow Medicine County, MN"
2020,Dec,5403,5183,220,4.1,"Yellow Medicine County, MN"
2021,Jan,5148,4861,287,5.6,"Yellow Medicine County, MN"
2021,Feb,5127,4877,250,4.9,"Yellow Medicine County, MN"
2021,Mar,5053,4834,219,4.3,"Yellow Medicine County, MN"
2021,Apr,4977,4825,152,3.1,"Yellow Medicine County, MN"
2021,May,5053,4915,138,2.7,"Yellow Medicine County, MN"
2021,Jun,5102,4924,178,3.5,"Yellow Medicine County, MN"
2021,Jul,5107,4967,140,2.7,"Yellow Medicine County, MN"
2021,Aug,5007,4865,142,2.8,"Yellow Medicine County, MN"
2021,Sep,4986,4882,104,2.1,"Yellow Medicine County, MN"
2021,Oct,5140,5052,88,1.7,"Yellow Medicine County, MN"
2021,Nov,5050,4963,87,1.7,"Yellow Medicine County, MN"
2021,Dec,5245,5107,138,2.6,"Yellow Medicine County, MN"
2022,Jan,5064,4867,197,3.9,"Yellow Medicine County, MN"
2022,Feb,5081,4903,178,3.5,"Yellow Medicine County, MN"
2022,Mar,5035,4865,170,3.4,"Yellow Medicine County, MN"
2022,Apr,4963,4850,113,2.3,"Yellow Medicine County, MN"
2022,May,4987,4880,107,2.1,"Yellow Medicine County, MN"
2022,Jun,5024,4884,140,2.8,"Yellow Medicine County, MN"
2022,Jul,5039,4913,126,2.5,"Yellow Medicine County, MN"
2022,Aug,4939,4804,135,2.7,"Yellow Medicine County, MN"
2022,Sep,4922,4831,91,1.8,"Yellow Medicine County, MN"
2022,Oct,5073,4987,86,1.7,"Yellow Medicine County, MN"
2022,Nov,4985,4886,99,2.0,"Yellow Medicine County, MN"
2022,Dec,5185,5016,169,3.3,"Yellow Medicine County, MN"
2023,Jan,4998,4800,198,4.0,"Yellow Medicine County, MN"
2023,Feb,5014,4823,191,3.8,"Yellow Medicine County, MN"
2023,Mar,5000,4821,179,3.6,"Yellow Medicine County, MN"
2023,Apr,4950,4817,133,2.7,"Yellow Medicine County, MN"
2023,May,4942,4822,120,2.4,"Yellow Medicine County, MN"
2023,Jun,4995,4808,187,3.7,"Yellow Medicine County, MN"
2023,Jul,4950,4765,185,3.7,"Yellow Medicine County, MN"
2023,Aug,5064,4873,191,3.8,"Yellow Medicine County, MN"
2023,Sep,5073,4962,111,2.2,"Yellow Medicine County, MN"
2023,Oct,5171,5068,103,2.0,"Yellow Medicine County, MN"
2023,Nov,5123,5042,81,1.6,"Yellow Medicine County, MN"
2023,Dec,5090,4960,130,2.6,"Yellow Medicine County, MN"
2024,Jan,4959,4781,178,3.6,"Yellow Medicine County, MN"
2024,Feb,4946,4764,182,3.7,"Yellow Medicine County, MN"
2024,Mar,5054,4890,164,3.2,"Yellow Medicine County, MN"
2024,Apr,5055,4918,137,2.7,"Yellow Medicine County, MN"
2024,May,4939,4796,143,2.9,"Yellow Medicine County, MN"
2024,Jun,5122,4891,231,4.5,"Yellow Medicine County, MN"
2024,Jul,5108,4890,218,4.3,"Yellow Medicine County, MN"
2024,Aug,5228,5036,192,3.7,"Yellow Medicine County, MN"
2024,Sep,5183,5073,110,2.1,"Yellow Medicine County, MN"
2024,Oct,5216,5110,106,2.0,"Yellow Medicine County, MN"
2024,Nov,5220(P),5090(P),130(P),2.5(P),"Yellow Medicine County, MN"
P : Preliminary.,P : Preliminary.,P : Preliminary.,P : Preliminary.,P : Preliminary.,P : Preliminary.,"Yellow Medicine County, MN"
